02 02 02 02 02 02 02 02 02 02 02 02 02 02 02 02 02 02 02 02 02 02 02 02 02 02 02 02 02 02 02 02 02 02 02 02 02 02 02 02 02 02 02 02 02 02 02 02 02 02 02 02 02 02 02 02 02 02
02 02 02 02 02 02 02 02 02 02 02 02 02 02 02 02 02 02 02 02 02 02 02 02 02 02 02 02 02 02 02 02 02 02 02 02 02 02 02 02 02 02 02 02 02 02 02 02 02 02 02 02 02 02 02 02 02 02
02 02 02 02 02 02 02 02 02 02 02 02 02 02 02 02 02 02 02 02 02 02 02 02 02 02 02 02 02 02 02 02 02 02 02 02 02 02 02 02 02 02 02 02 02 02 02 02 02 02 02 02 02 02 02 02 02 02
02 02 02 02 02 02 02 02 02 02 02 02 02 02 02 02 02 02 02 02 02 02 02 02 02 02 02 02 02 02 02 02 02 02 02 02 02 02 02 02 02 02 02 02 02 02 02 02 02 02 02 02 02 02 02 02 02 02
02 02 02 02 02 02 02 02 02 02 02 02 02 02 02 02 02 02 02 02 02 02 02 02 02 02 02 02 02 02 02 02 02 02 02 02 02 02 02 02 02 02 02 02 02 02 02 02 02 02 02 02 02 02 02 02 02 02
02 02 02 02 02 02 02 03 03 03 03 03 03 03 03 03 03 03 03 03 03 03 03 03 03 03 03 03 03 03 03 03 03 03 03 03 03 03 03 03 03 03 03 03 03 03 03 03 03 03 03 02 02 02 02 02 02 02
02 02 02 02 02 02 02 03 01 01 01 01 01 01 01 01 01 01 01 01 01 01 01 01 01 01 01 01 01 01 01 01 01 01 01 01 01 01 01 01 01 01 01 01 01 01 01 01 01 01 03 02 02 02 02 02 02 02
02 02 02 02 02 02 02 03 10 10 10 10 10 10 10 10 10 10 10 10 10 10 10 10 10 10 10 10 10 10 10 10 10 10 10 10 10 10 10 10 10 10 10 10 10 10 10 10 10 10 03 02 02 02 02 02 02 02
02 02 02 02 02 02 02 03 10 10 10 10 10 10 10 10 10 10 10 10 10 10 10 10 10 10 10 10 10 10 10 10 10 10 10 10 10 10 10 10 10 10 10 10 10 10 10 10 10 10 03 02 02 02 02 02 02 02
02 02 02 02 02 02 02 03 10 10 10 10 10 10 10 10 10 10 10 10 10 10 03 03 03 03 03 03 03 03 10 10 10 10 10 10 10 10 10 10 10 10 10 10 10 10 10 10 10 10 03 02 02 02 02 02 02 02
02 02 02 02 02 02 02 03 12 12 12 12 12 12 12 12 10 10 10 10 10 10 03 01 01 01 01 01 01 03 10 10 02 02 02 10 10 10 10 10 10 10 10 10 10 10 10 10 10 10 03 02 02 02 02 02 02 02
02 02 02 02 02 02 12 03 12 12 12 12 12 12 12 12 10 10 10 10 10 10 03 09 09 09 09 09 09 03 10 02 02 02 02 02 10 10 10 10 10 10 10 10 10 10 10 10 10 10 03 02 02 02 02 02 02 02
02 02 02 02 02 02 12 03 12 12 12 12 12 12 12 12 12 12 10 10 10 10 03 09 09 09 09 09 09 03 10 02 02 02 02 02 10 10 10 10 10 10 10 10 10 10 10 10 10 10 03 02 02 02 02 02 02 02
02 02 02 02 02 02 12 03 12 04 04 04 04 04 04 12 12 12 10 10 10 10 03 09 09 09 09 09 09 03 10 02 02 02 02 02 10 10 10 10 10 10 10 10 10 10 10 10 10 10 03 02 02 02 02 02 02 02
02 02 02 02 02 02 12 03 12 04 04 04 04 12 04 12 12 12 10 10 10 10 03 03 03 09 03 03 03 03 10 02 02 02 02 02 10 10 10 10 10 10 10 10 10 10 10 10 10 10 03 02 02 02 02 02 02 02
02 02 02 02 02 02 12 03 12 04 04 04 04 04 04 12 12 12 10 10 10 10 01 01 01 09 01 01 01 01 10 10 02 02 02 10 10 10 10 10 10 10 10 10 10 10 10 10 10 10 03 02 02 02 02 02 02 02
02 02 02 02 02 02 12 03 04 04 04 04 04 04 04 12 12 12 10 10 10 10 08 05 00 07 07 00 08 08 10 10 10 10 10 10 10 10 10 10 10 10 10 10 10 10 10 10 10 10 03 02 02 02 02 02 02 02
02 02 02 02 02 02 12 03 12 04 12 04 04 04 04 12 12 12 10 10 10 10 05 08 00 07 07 00 05 08 10 10 10 10 10 10 10 10 10 10 10 10 10 10 10 10 10 10 10 10 03 02 02 02 02 02 02 02
02 02 02 02 02 02 12 03 12 04 04 04 04 04 04 12 12 12 10 10 10 10 08 08 03 03 07 03 08 08 10 10 10 10 10 10 10 10 10 10 10 10 10 10 10 10 10 10 10 10 03 02 02 02 02 02 02 02
02 02 02 02 02 02 12 03 12 04 04 04 04 04 04 12 12 12 10 10 10 10 05 05 01 01 07 01 08 05 10 10 10 10 10 10 10 10 10 10 06 06 06 06 06 10 10 10 10 10 03 02 02 02 02 02 02 02
02 02 02 02 02 02 12 03 04 04 04 04 04 04 04 12 12 12 10 10 10 10 05 08 00 07 07 00 05 05 10 10 10 10 10 10 10 10 10 10 06 10 10 10 06 10 10 10 10 10 03 02 02 02 02 02 02 02
02 02 02 02 02 02 12 03 04 04 04 12 04 04 04 12 12 12 10 10 10 10 08 05 00 07 07 00 08 05 10 10 10 10 10 06 06 06 06 06 06 10 06 06 06 10 10 10 10 10 03 02 02 02 02 02 02 02
02 02 02 02 02 02 12 03 12 04 04 04 04 04 04 12 12 12 02 02 10 10 08 08 03 07 03 03 05 05 10 10 10 10 10 06 06 06 10 10 10 10 06 10 10 10 10 10 10 10 03 02 02 02 02 02 02 02
02 02 02 02 02 02 12 03 04 04 04 04 04 04 04 12 12 02 02 02 02 10 08 05 01 07 01 01 05 08 10 10 10 10 10 06 06 06 10 10 10 10 06 10 10 10 10 10 10 10 03 02 02 02 02 02 02 02
02 02 02 02 02 02 12 03 12 04 04 04 04 04 04 12 12 02 02 02 02 10 05 08 00 07 07 00 08 05 10 10 10 10 10 06 06 06 10 10 10 10 06 10 10 10 10 10 10 10 03 02 02 02 02 02 02 02
02 02 02 02 02 02 12 03 04 04 04 04 04 04 04 04 04 00 00 00 00 00 00 00 00 07 07 00 08 08 10 10 10 10 10 10 10 10 10 10 10 10 06 10 10 10 10 10 10 10 03 02 02 02 02 02 02 02
02 02 02 02 02 02 12 03 04 04 04 04 04 04 04 07 07 07 07 07 07 07 07 07 07 07 07 00 05 05 10 10 10 10 10 10 10 10 10 10 10 10 06 10 10 10 10 10 10 10 03 02 02 02 02 02 02 02
02 02 02 02 02 02 12 03 12 04 04 04 04 04 04 07 07 07 07 07 07 07 07 07 07 07 07 00 05 08 10 10 10 10 10 10 10 10 10 10 10 10 06 06 10 10 10 10 10 10 03 02 02 02 02 02 02 02
02 02 02 02 02 02 12 03 12 04 04 04 04 04 04 04 04 10 10 10 10 10 05 05 00 07 07 00 08 05 10 10 10 10 10 10 10 10 10 10 10 10 10 06 10 10 10 10 10 10 03 02 02 02 02 02 02 02
02 02 02 02 02 02 12 03 12 12 12 12 12 12 12 12 10 10 10 10 10 10 05 08 00 07 07 00 00 00 00 00 00 00 00 00 00 00 00 10 10 10 10 06 06 10 10 10 10 10 03 02 02 02 02 02 02 02
02 02 02 02 02 02 12 03 12 12 12 12 12 12 12 12 10 10 10 10 10 10 08 05 00 07 07 07 07 07 07 07 07 07 07 07 07 07 07 10 10 10 10 10 06 10 10 10 10 10 03 02 02 02 02 02 02 02
02 02 02 02 02 02 12 03 10 10 10 10 10 10 10 10 10 10 10 10 10 10 05 08 00 07 07 07 07 07 07 07 07 07 07 07 07 07 07 06 06 10 10 10 06 10 10 10 10 10 03 02 02 02 02 02 02 02
02 02 02 02 02 02 12 03 10 10 10 10 10 10 10 10 10 10 10 10 10 10 05 05 00 07 07 00 00 00 00 00 00 00 00 00 00 00 00 10 06 10 10 10 06 10 10 10 10 10 03 02 02 02 02 02 02 02
02 02 02 02 02 02 12 03 10 10 10 10 10 10 10 10 10 10 10 10 10 10 08 05 00 07 07 00 08 08 10 10 10 10 10 10 10 10 10 10 06 10 10 10 06 10 10 10 10 10 03 02 02 02 02 02 02 02
02 02 02 02 02 02 12 03 10 10 10 10 10 10 10 10 10 10 10 10 10 10 05 08 00 07 07 00 05 08 10 10 10 10 10 10 10 10 10 10 06 10 10 10 06 10 10 10 10 10 03 02 02 02 02 02 02 02
02 02 02 02 02 02 12 03 10 10 10 10 10 10 10 10 10 10 10 10 10 10 08 05 00 07 07 00 05 05 10 10 10 10 10 10 10 10 06 06 06 10 10 10 06 10 10 10 10 10 03 02 02 02 02 02 02 02
02 02 02 02 02 02 04 03 10 13 14 13 14 13 10 10 10 10 10 10 10 10 05 08 00 07 07 00 08 08 10 10 10 10 10 10 10 10 06 10 10 10 10 10 06 10 10 10 10 10 03 02 02 02 02 02 02 02
02 02 02 02 02 02 04 03 10 14 13 14 13 14 10 10 10 10 10 13 14 13 14 13 00 07 07 00 13 14 13 14 13 10 10 10 10 10 06 10 10 10 10 10 06 10 10 10 10 10 03 02 02 02 02 02 02 02
02 02 02 02 02 02 04 03 10 13 14 13 14 13 14 07 07 07 07 07 07 07 07 07 07 07 07 07 07 07 07 07 07 10 10 10 10 10 06 10 10 10 10 10 06 10 10 10 10 10 03 02 02 02 02 02 02 02
02 02 02 02 02 02 04 03 10 14 13 14 13 14 10 10 10 10 10 08 05 05 08 05 08 05 05 08 05 08 08 05 07 10 10 10 10 10 06 06 06 06 06 06 06 10 10 10 10 10 03 02 02 02 02 02 02 02
02 02 02 02 02 02 12 03 10 13 14 13 14 13 10 10 10 10 10 10 10 10 10 10 10 10 10 10 10 10 10 10 07 10 10 10 10 10 10 10 10 10 10 10 10 10 10 10 10 10 03 02 02 02 02 02 02 02
02 02 02 02 02 02 04 03 10 14 13 14 13 14 10 10 10 10 10 10 10 10 10 10 10 10 10 10 10 10 10 10 07 10 10 10 10 10 10 10 10 10 10 10 10 10 10 10 10 10 03 02 02 02 02 02 02 02
02 02 02 02 02 02 04 03 10 10 10 10 10 10 10 10 10 10 10 10 10 10 10 10 10 10 10 10 10 10 10 10 07 10 10 10 10 10 10 10 10 10 10 10 10 10 10 10 10 10 03 02 02 02 02 02 02 02
02 02 02 02 02 02 04 03 10 10 10 10 10 10 10 10 10 10 10 10 10 10 10 10 10 10 10 10 10 10 10 10 07 10 10 10 10 10 10 10 10 10 10 10 10 10 10 10 10 10 03 02 02 02 02 02 02 02
02 02 02 02 02 02 04 03 03 03 03 03 03 03 03 03 03 03 03 03 03 03 03 03 03 03 03 03 03 03 03 03 07 03 03 03 03 03 03 03 03 03 03 03 03 03 03 03 03 03 03 02 02 02 02 02 02 02
02 02 02 02 02 02 04 01 01 01 01 01 01 01 01 01 01 01 01 01 01 01 01 01 01 01 01 01 01 01 01 01 07 01 01 01 01 01 01 01 01 01 01 01 01 01 01 01 01 01 01 02 02 02 02 02 02 02
02 02 02 02 02 02 04 04 04 04 04 04 04 04 04 04 04 04 04 04 04 04 04 04 04 04 04 04 04 04 04 04 04 04 04 04 04 04 04 04 04 04 04 04 04 04 04 04 04 04 04 02 02 02 02 02 02 02
02 02 02 02 02 02 02 02 02 02 02 02 02 02 02 02 02 02 02 02 02 02 02 02 02 02 02 02 11 11 02 02 02 02 02 02 02 02 02 02 02 02 02 02 02 02 02 02 02 02 02 02 02 02 02 02 02 02
02 02 02 02 02 02 02 02 02 02 02 02 02 02 02 02 02 02 02 02 02 02 02 02 02 02 02 02 11 11 02 02 02 02 02 02 02 02 02 02 02 02 02 02 02 02 02 02 02 02 02 02 02 02 02 02 02 02
02 02 02 02 02 02 02 02 02 02 02 02 02 02 02 02 02 02 02 02 02 02 02 02 02 02 02 02 11 11 02 02 02 02 02 02 02 02 02 02 02 02 02 02 02 02 02 02 02 02 02 02 02 02 02 02 02 02
02 02 02 02 02 02 02 02 02 02 02 02 02 02 02 02 02 02 02 02 02 02 02 02 02 02 02 02 11 11 02 02 02 02 02 02 02 02 02 11 11 11 02 02 02 02 02 02 02 02 02 02 02 02 02 02 02 02
02 02 02 02 02 02 02 02 02 02 02 02 02 02 02 02 02 02 02 02 02 02 02 02 02 02 02 02 11 11 02 02 02 02 02 02 02 02 02 11 11 11 02 02 02 02 02 02 02 02 02 02 02 02 02 02 02 02
02 02 02 02 02 02 02 02 02 02 02 02 02 02 02 02 02 02 02 02 02 02 02 02 02 02 02 02 11 11 11 11 11 11 11 11 11 11 11 11 11 11 02 02 02 02 02 02 02 02 02 02 02 02 02 02 02 02
02 02 02 02 02 02 02 02 02 02 02 02 02 02 02 02 02 02 02 02 02 02 02 02 02 02 02 02 11 11 11 11 11 11 11 11 11 11 11 11 11 11 02 02 02 02 02 02 02 02 02 02 02 02 02 02 02 02
02 02 02 02 02 02 02 02 02 02 02 02 02 02 02 02 02 02 02 02 02 02 02 02 02 02 02 02 02 02 02 02 02 02 02 02 02 02 02 02 02 02 02 02 02 02 02 02 02 02 02 02 02 02 02 02 02 02
02 02 02 02 02 02 02 02 02 02 02 02 02 02 02 02 02 02 02 02 02 02 02 02 02 02 02 02 02 02 02 02 02 02 02 02 02 02 02 02 02 02 02 02 02 02 02 02 02 02 02 02 02 02 02 02 02 02
02 02 02 02 02 02 02 02 02 02 02 02 02 02 02 02 02 02 02 02 02 02 02 02 02 02 02 02 02 02 02 02 02 02 02 02 02 02 02 02 02 02 02 02 02 02 02 02 02 02 02 02 02 02 02 02 02 02
02 02 02 02 02 02 02 02 02 02 02 02 02 02 02 02 02 02 02 02 02 02 02 02 02 02 02 02 02 02 02 02 02 02 02 02 02 02 02 02 02 02 02 02 02 02 02 02 02 02 02 02 02 02 02 02 02 02
02 02 02 02 02 02 02 02 02 02 02 02 02 02 02 02 02 02 02 02 02 02 02 02 02 02 02 02 02 02 02 02 02 02 02 02 02 02 02 02 02 02 02 02 02 02 02 02 02 02 02 02 02 02 02 02 02 02
02 02 02 02 02 02 02 02 02 02 02 02 02 02 02 02 02 02 02 02 02 02 02 02 02 02 02 02 02 02 02 02 02 02 02 02 02 02 02 02 02 02 02 02 02 02 02 02 02 02 02 02 02 02 02 02 02 02