24 24 24 24 24 24 24 24 24 24 24 24 24 24 24 24 24 24 24 24 24 24 24 24 24 24 24 24 24 24 24 24 24 24 24 24 24 24 24 24 24 24 24 24 24 24 24 24 24 24
24 24 24 24 24 24 24 24 24 24 24 24 24 24 24 24 24 24 24 24 24 24 24 24 24 24 24 24 24 24 24 24 24 24 24 24 24 24 24 24 24 24 24 24 24 24 24 24 24 24
24 24 24 24 24 24 24 24 24 24 24 24 24 24 24 24 24 24 24 24 24 24 24 24 24 24 24 24 24 24 24 24 24 24 24 24 24 24 24 24 24 24 24 24 24 24 24 24 24 24
24 24 24 24 24 24 24 24 24 24 24 24 24 24 24 24 24 24 24 24 24 24 24 24 24 24 24 24 24 24 24 24 24 24 24 24 24 24 24 24 24 24 24 24 24 24 24 24 24 24
24 24 24 24 24 24 24 24 24 24 24 24 24 24 24 24 24 24 24 24 24 24 24 24 24 24 24 24 24 24 24 24 24 24 24 24 24 24 24 24 24 24 24 24 24 24 24 24 24 24
24 24 24 24 24 24 4 8 8 8 8 8 8 8 8 8 8 8 8 8 8 8 8 8 8 8 8 8 8 8 8 8 8 8 8 8 8 8 8 8 8 8 8 3 24 24 24 24 24 24
24 24 24 24 24 5 26 26 26 26 26 26 26 26 26 26 26 31 26 26 26 26 26 26 26 26 31 26 26 26 26 26 26 26 26 26 26 26 26 26 26 26 26 26 6 24 24 24 24 24
24 24 24 24 24 5 26 26 26 26 26 31 26 26 26 26 26 26 26 26 26 26 26 26 26 26 26 26 26 26 26 26 26 31 26 26 26 26 26 26 26 26 26 26 6 24 24 24 24 24
24 24 24 24 24 5 26 26 26 26 26 26 26 26 26 26 26 26 26 26 26 31 26 26 26 26 26 26 31 26 26 26 26 26 26 26 26 26 26 26 26 26 26 26 6 24 24 24 24 24
24 24 24 24 24 5 26 26 26 20 15 15 15 15 15 15 15 15 15 15 15 15 15 15 15 15 15 15 15 15 15 15 15 15 15 15 15 15 15 15 19 31 26 26 6 24 24 24 24 24
24 24 24 24 24 5 26 26 26 22 14 28 47 46 48 14 14 14 14 14 14 14 14 14 14 14 14 14 14 14 14 14 14 14 14 14 14 14 14 29 21 26 26 26 6 24 24 24 24 24
24 24 24 24 24 5 26 31 26 22 13 14 43 49 45 29 14 14 14 14 14 14 29 13 14 14 14 14 14 14 13 14 14 28 14 14 30 14 14 14 21 26 31 26 6 24 24 24 24 24
24 24 24 24 24 5 26 26 26 22 14 14 37 36 38 14 14 14 14 14 14 14 14 14 14 14 30 14 14 30 14 14 29 14 14 14 14 14 14 14 21 26 26 26 6 24 24 24 24 24
24 24 24 24 24 5 26 26 26 22 14 14 14 14 28 29 28 29 28 29 28 29 14 28 14 14 14 14 14 14 14 14 14 14 14 14 14 13 14 14 21 26 26 26 6 24 24 24 24 24
24 24 24 24 24 5 26 26 26 22 14 14 14 14 29 33 33 33 33 33 33 28 14 14 14 14 14 14 14 30 30 32 30 30 30 30 30 30 30 14 21 26 26 26 6 24 24 24 24 24
24 24 24 24 24 5 26 26 26 22 14 14 14 14 28 33 33 33 33 33 33 29 14 14 14 14 14 14 30 30 25 25 25 25 25 25 25 30 14 14 21 26 26 26 6 24 24 24 24 24
24 24 24 24 24 5 26 26 26 22 14 14 14 14 29 33 27 27 27 27 33 28 14 14 14 14 32 14 32 30 25 30 30 30 30 32 25 30 14 30 21 31 26 26 6 24 24 24 24 24
24 24 24 24 24 5 26 26 26 22 29 14 14 14 28 33 27 27 27 27 33 29 14 14 14 14 30 14 30 30 25 30 32 30 30 30 25 30 32 14 21 26 26 26 6 24 24 24 24 24
24 24 24 24 24 5 26 26 26 22 14 14 14 14 29 33 27 27 27 27 33 28 14 14 14 14 14 14 30 32 25 25 25 25 30 30 25 32 14 14 21 26 31 26 6 24 24 24 24 24
24 24 24 24 24 5 26 31 26 22 14 14 14 14 28 33 33 27 33 33 33 29 14 14 14 14 14 14 30 30 30 30 32 25 30 30 25 32 14 29 21 26 26 26 6 24 24 24 24 24
24 24 24 24 24 5 26 26 26 22 14 14 14 14 14 12 11 25 11 12 11 14 14 14 14 14 14 14 30 30 32 30 30 25 30 32 25 30 14 14 21 26 26 26 6 24 24 24 24 24
24 24 24 24 24 5 26 26 31 22 14 47 48 13 14 14 14 25 25 25 25 25 25 25 25 25 25 25 25 25 25 25 25 25 30 30 25 30 30 13 21 26 26 26 6 24 24 24 24 24
24 24 24 24 24 5 26 26 26 22 14 43 45 14 28 14 14 25 47 46 46 46 46 48 14 14 14 14 30 14 32 30 30 30 30 30 25 30 14 14 21 26 31 26 6 24 24 24 24 24
24 24 24 24 24 5 26 26 26 22 14 43 40 46 46 48 14 25 43 35 35 35 49 45 13 14 14 14 14 30 14 30 30 30 32 30 25 30 14 30 21 26 26 26 6 24 24 24 24 24
24 24 24 24 24 5 26 26 26 22 14 43 49 35 35 40 46 10 39 35 49 35 35 45 13 14 30 14 14 14 30 30 30 30 30 30 25 32 14 14 21 31 26 26 6 24 24 24 24 24
24 24 24 24 24 5 26 26 26 22 14 43 35 35 49 35 35 10 35 35 35 42 36 38 14 14 14 30 14 30 30 32 30 30 30 25 25 30 30 13 21 26 26 26 6 24 24 24 24 24
24 24 24 24 24 5 26 26 26 22 14 43 35 35 35 35 35 35 35 49 42 38 14 14 32 30 30 30 32 30 25 25 25 25 25 25 30 30 14 14 21 26 26 26 6 24 24 24 24 24
24 24 24 24 24 5 26 26 26 22 14 37 36 41 35 49 35 49 35 42 38 14 14 14 30 25 25 25 25 30 25 30 30 30 30 32 30 14 14 14 21 31 26 26 6 24 24 24 24 24
24 24 24 24 24 5 26 26 31 22 14 14 14 37 36 41 42 36 36 38 28 14 14 32 30 25 25 25 25 25 25 30 14 32 14 14 14 14 14 14 21 26 26 26 6 24 24 24 24 24
24 24 24 24 24 5 26 26 26 22 14 14 14 14 29 37 38 14 14 14 14 14 14 14 30 25 25 25 25 30 30 14 14 14 30 13 13 14 14 29 21 26 26 26 6 24 24 24 24 24
24 24 24 24 24 5 26 26 26 22 14 29 13 14 14 14 14 14 14 14 14 14 14 30 30 25 25 25 25 30 14 30 14 14 14 14 14 14 14 14 21 26 26 31 6 24 24 24 24 24
24 24 24 24 24 5 26 26 26 22 14 14 14 14 14 14 14 13 14 14 14 14 14 14 30 32 30 30 30 30 30 14 14 14 28 14 14 14 14 14 21 26 26 26 6 24 24 24 24 24
24 24 24 24 24 5 26 26 31 22 14 14 14 14 14 14 14 14 14 14 14 14 14 14 14 14 14 14 32 14 14 14 14 14 14 14 14 14 13 14 21 26 26 26 6 24 24 24 24 24
24 24 24 24 24 5 26 26 26 22 14 14 14 14 14 14 14 14 14 14 14 14 14 14 14 14 14 14 14 14 14 13 13 14 14 14 14 14 29 14 21 31 26 26 6 24 24 24 24 24
24 24 24 24 24 5 26 26 26 22 13 14 14 14 14 14 14 14 28 14 14 14 14 14 14 13 14 14 14 14 14 14 14 14 14 14 14 14 14 14 21 26 26 26 6 24 24 24 24 24
24 24 24 24 24 5 26 26 26 22 14 14 14 14 14 14 14 14 14 14 14 14 14 29 14 14 14 14 14 14 14 14 14 14 14 14 14 14 14 13 21 26 26 26 6 24 24 24 24 24
24 24 24 24 24 5 26 26 26 22 14 14 14 28 14 14 14 14 14 14 14 14 14 14 14 14 14 14 14 14 11 11 11 12 11 13 14 14 14 14 21 26 26 26 6 24 24 24 24 24
24 24 24 24 24 5 26 31 26 22 14 14 13 14 14 14 14 14 14 29 14 14 14 14 14 14 29 14 14 14 12 9 9 9 11 14 14 14 28 14 21 26 26 26 6 24 24 24 24 24
24 24 24 24 24 5 26 26 26 22 14 14 14 14 14 13 14 14 14 14 14 14 14 14 14 14 14 14 14 14 11 12 9 9 12 29 14 14 14 14 21 26 26 26 6 24 24 24 24 24
24 24 24 24 24 5 26 26 26 22 14 14 14 14 14 14 14 14 14 14 14 14 14 14 28 14 14 14 14 14 14 11 12 11 14 14 14 14 14 14 21 26 31 26 6 24 24 24 24 24
24 24 24 24 24 5 26 26 26 18 23 23 23 23 23 23 23 23 23 23 23 23 23 23 23 23 23 23 23 23 23 23 23 23 23 23 23 23 23 23 17 26 31 26 6 24 24 24 24 24
24 24 24 24 24 5 26 26 26 31 26 26 26 26 31 26 26 26 26 26 31 26 26 26 26 26 26 26 26 31 31 26 26 26 26 26 26 26 26 31 26 26 26 26 6 24 24 24 24 24
24 24 24 24 24 5 26 26 26 26 26 26 31 26 26 26 26 26 26 26 26 26 26 26 26 26 26 26 26 26 26 26 26 26 26 31 26 26 26 26 26 26 26 26 6 24 24 24 24 24
24 24 24 24 24 5 26 26 26 26 26 26 26 26 26 26 26 26 26 26 26 26 26 26 31 26 26 26 26 26 26 26 26 26 26 26 26 26 26 26 26 26 26 26 6 24 24 24 24 24
24 24 24 24 24 24 2 7 7 7 7 7 7 7 7 7 7 7 7 7 7 7 7 7 7 7 7 7 7 7 7 7 7 0 0 0 0 0 0 0 0 0 0 1 24 24 24 24 24 24
24 24 24 24 24 24 24 24 24 24 24 24 24 24 24 24 24 24 24 24 24 24 24 24 24 24 24 24 24 24 24 24 24 24 24 24 24 24 24 24 24 24 24 24 24 24 24 24 24 24
24 24 24 24 24 24 24 24 24 24 24 24 24 24 24 24 24 24 24 24 24 24 24 24 24 24 24 24 24 24 24 24 24 24 24 24 24 24 24 24 24 24 24 24 24 24 24 24 24 24
24 24 24 24 24 24 24 24 24 24 24 24 24 24 24 24 24 24 24 24 24 24 24 24 24 24 24 24 24 24 24 24 24 24 24 24 24 24 24 24 24 24 24 24 24 24 24 24 24 24
24 24 24 24 24 24 24 24 24 24 24 24 24 24 24 24 24 24 24 24 24 24 24 24 24 24 24 24 24 24 24 24 24 24 24 24 24 24 24 24 24 24 24 24 24 24 24 24 24 24
24 24 24 24 24 24 24 24 24 24 24 24 24 24 24 24 24 24 24 24 24 24 24 24 24 24 24 24 24 24 24 24 24 24 24 24 24 24 24 24 24 24 24 24 24 24 24 24 24 24
