27 27 27 27 27 27 27 27 27 27 27 27 27 27 27 27 27 27 27 27 27 27 27 27 27 27 27 27 27 27 27 27 27 27 27 27 27 27 27 27 27 27 27 27 27 27 27 27 27 27 27 27 27 27 27 27 27 27 27 27 27 27 27 27 27 27 27 27 27 27 27 27 27 27 27 27 27 27 27 27 27 27 27 27 27 27 27 27 27 27 27 27 27 27 27 27 27 27 27 27 
27 27 27 27 27 27 27 27 27 27 27 27 27 27 27 27 27 27 27 27 27 27 27 27 27 27 27 27 27 27 27 27 27 27 27 27 27 27 27 27 27 27 27 27 27 27 27 27 27 27 27 27 27 27 27 27 27 27 27 27 27 27 27 27 27 27 27 27 27 27 27 27 27 27 27 27 27 27 27 27 27 27 27 27 27 27 27 27 27 27 27 27 27 27 27 27 27 27 27 27 
27 27 27 27 27 27 27 27 27 27 27 27 27 27 27 27 27 27 27 27 27 27 27 27 27 27 27 27 27 27 27 27 27 27 27 27 27 27 27 27 27 27 27 27 27 27 27 27 27 27 27 27 27 27 27 27 27 27 27 27 27 27 27 27 27 27 27 27 27 27 27 27 27 27 27 27 27 27 27 27 27 27 27 27 27 27 27 27 27 27 27 27 27 27 27 27 27 27 27 27 
27 27 27 27 27 27 27 27 27 27 27 27 27 27 10 8 8 8 8 8 8 8 8 8 8 8 8 8 8 8 8 9 27 27 27 27 27 27 27 27 27 27 27 27 27 27 27 27 27 27 27 27 27 27 27 27 27 27 27 27 27 27 27 27 27 27 27 27 27 27 27 27 27 27 27 27 27 27 27 27 27 27 27 27 27 27 27 27 27 27 27 27 27 27 27 27 27 27 27 27 
27 27 27 27 27 27 27 27 27 27 27 27 27 27 5 29 29 29 29 29 34 29 29 29 29 29 29 29 29 29 29 64 8 9 27 27 27 27 27 27 27 8 8 8 8 8 8 8 8 8 8 8 8 8 8 8 8 8 8 8 8 8 8 8 8 8 8 8 8 8 8 8 8 8 8 8 8 8 8 8 8 8 8 8 8 8 8 8 8 8 8 8 8 8 8 9 27 27 27 27 
27 27 27 27 27 27 27 27 27 27 27 10 8 8 65 29 29 23 19 19 19 19 19 19 19 19 19 19 19 19 22 29 29 64 8 9 27 27 27 27 27 29 29 29 29 29 29 29 29 29 29 29 29 29 29 29 29 29 29 29 29 29 29 29 29 29 29 29 29 29 29 29 29 29 29 29 29 29 29 29 29 29 29 29 29 29 29 29 29 29 29 29 29 29 29 6 27 27 27 27 
27 27 27 27 27 27 27 27 27 10 8 65 23 19 19 19 19 68 90 90 90 17 90 90 90 90 90 90 90 18 69 19 19 22 29 64 9 27 27 27 27 29 29 29 29 29 29 29 29 29 29 29 29 29 29 29 29 29 29 29 29 29 29 29 29 29 29 29 29 29 29 29 29 29 29 29 29 29 29 29 29 29 29 29 29 29 29 29 29 29 29 29 29 29 29 6 27 27 27 27 
27 27 27 27 27 27 27 10 8 65 23 19 68 18 90 18 90 90 91 91 91 17 91 91 91 91 91 91 91 90 18 18 18 24 29 29 6 27 27 27 27 29 29 29 29 29 29 29 29 29 29 29 29 29 29 29 29 29 29 29 29 29 29 29 29 29 29 29 29 29 29 29 29 29 29 29 29 29 29 29 29 29 29 29 29 29 29 29 29 29 29 29 29 29 29 6 27 27 27 27 
27 27 27 27 27 27 10 65 23 19 68 18 18 90 91 90 91 91 17 17 17 17 90 90 90 90 90 90 90 91 18 18 18 24 34 29 6 27 27 27 27 19 19 19 19 19 19 19 19 19 19 19 19 19 19 19 19 19 19 19 19 19 19 19 19 19 19 19 19 19 19 19 19 19 19 19 19 19 19 19 19 19 19 19 19 19 19 19 19 19 19 22 29 29 29 6 27 27 27 27 
27 27 27 27 27 27 5 23 68 17 17 18 18 91 90 91 18 18 18 32 17 17 91 91 91 91 91 91 91 18 18 18 18 24 29 29 6 27 27 27 27 18 18 18 18 18 18 18 18 18 18 18 18 18 18 18 18 18 18 18 18 18 18 18 18 18 18 18 18 18 18 18 18 18 18 18 18 18 18 18 18 18 18 18 18 18 18 18 18 18 18 24 29 29 29 6 27 27 27 27 
27 27 27 27 27 10 65 25 18 17 18 90 90 90 91 18 18 18 18 18 17 17 17 17 17 17 17 18 18 18 18 18 18 24 34 29 6 27 27 27 27 18 18 18 18 18 18 18 18 18 18 18 18 18 18 18 18 18 18 18 18 18 18 18 18 18 18 18 18 18 18 18 18 18 18 18 18 18 18 18 18 18 18 18 18 18 18 18 18 18 18 24 29 29 29 6 27 27 27 27 
27 27 27 27 27 5 23 68 18 90 90 91 91 91 18 18 18 81 80 79 18 18 18 18 31 18 16 15 16 18 18 32 18 24 29 34 6 27 27 27 27 18 18 18 18 18 18 18 18 18 18 18 18 18 18 18 18 18 18 18 18 18 18 18 18 18 18 18 18 18 18 18 18 18 18 18 18 18 18 18 18 18 18 18 18 18 18 18 18 18 18 24 29 29 29 6 27 27 27 27 
27 27 27 27 10 65 25 18 18 91 91 90 18 18 18 18 18 89 88 87 18 18 18 18 18 18 15 16 15 18 18 18 18 69 22 29 6 27 27 27 27 18 18 18 18 18 18 18 18 18 18 18 18 18 18 18 18 18 18 18 18 18 18 18 18 18 18 18 18 18 18 18 18 18 18 18 18 18 18 18 18 18 18 18 18 18 18 18 18 18 18 24 29 29 29 6 27 27 27 27 
27 27 27 27 5 29 25 18 18 90 90 91 18 18 17 18 18 86 85 84 18 18 18 18 17 17 18 18 17 18 18 18 18 18 24 66 11 27 27 27 27 18 18 18 18 18 18 18 18 18 18 18 18 18 18 18 18 18 18 18 18 18 18 18 18 18 18 18 18 18 18 18 18 18 18 18 18 18 18 18 18 18 18 18 18 18 18 18 18 18 18 24 29 29 29 6 27 27 27 27 
27 27 27 27 5 29 25 18 18 91 91 90 18 31 18 18 18 83 82 78 18 17 18 18 18 17 17 17 32 18 18 18 18 18 24 6 27 27 27 27 18 18 18 18 18 18 18 18 18 18 18 18 18 18 18 18 18 18 18 18 18 18 18 18 18 18 18 18 18 18 18 18 18 18 18 18 18 18 18 18 18 18 18 18 18 18 18 18 18 18 18 24 29 29 29 6 27 27 27 27 
27 27 27 27 5 29 25 90 90 90 90 91 18 18 18 17 18 16 28 15 18 18 18 31 18 18 18 18 18 18 18 18 18 31 24 6 27 27 27 27 18 18 18 18 18 18 18 18 18 18 18 18 18 18 18 18 18 18 18 18 18 18 18 18 18 18 18 18 18 18 18 18 18 18 18 18 18 18 18 18 18 18 18 18 18 18 18 18 18 18 18 24 29 29 29 6 27 27 27 27 
27 27 27 27 5 29 25 91 91 91 91 90 18 18 17 17 18 18 28 18 93 28 28 92 18 18 18 18 18 18 18 18 18 18 24 6 27 27 27 27 18 18 18 18 18 18 18 18 18 18 18 18 18 18 18 18 18 18 18 18 18 18 18 18 18 18 18 18 18 18 18 18 18 18 18 18 18 18 18 18 18 18 18 18 18 18 18 18 18 18 18 24 29 29 29 6 27 27 27 27 
27 27 27 27 5 29 25 90 90 90 90 91 32 18 18 31 18 18 28 31 28 76 77 28 16 18 18 18 18 18 18 18 18 18 37 37 37 37 37 37 37 18 18 18 18 18 18 18 18 18 18 18 18 18 18 18 18 18 18 18 18 18 18 18 18 18 18 18 18 18 18 18 18 18 18 18 18 18 18 18 18 18 18 18 18 18 18 18 18 18 18 24 29 29 29 6 27 27 27 27 
27 27 27 27 5 29 25 91 91 91 91 18 18 18 18 18 18 18 28 28 28 74 75 28 28 28 28 28 28 28 28 28 28 28 14 14 14 14 14 14 14 18 18 18 18 18 18 18 18 18 18 18 18 18 18 18 18 18 18 18 18 18 18 18 18 18 18 18 18 18 18 18 18 18 18 18 18 18 18 18 18 18 18 18 18 18 18 18 18 18 18 24 29 29 29 6 27 27 27 27 
27 27 27 27 5 29 25 90 90 90 18 18 15 18 17 18 32 18 94 28 28 28 28 95 18 17 17 17 17 18 18 18 18 18 37 37 37 37 37 37 37 18 18 18 18 18 18 18 18 18 18 18 18 18 18 18 18 18 18 18 18 18 18 18 18 18 18 18 18 18 18 18 18 18 18 18 18 18 18 18 18 18 18 18 18 18 18 18 18 18 18 24 29 29 29 6 27 27 27 27 
27 27 27 27 5 29 25 91 91 91 90 90 18 18 17 18 18 18 18 18 18 17 17 18 18 17 17 18 18 18 18 18 18 18 24 6 27 27 27 27 18 18 18 18 18 18 18 18 18 18 18 18 18 18 18 18 18 18 18 18 18 18 18 18 18 18 18 18 18 18 18 18 18 18 18 18 18 18 18 18 18 18 18 18 18 18 18 18 18 18 18 24 29 29 29 6 27 27 27 27 
27 27 27 27 5 29 25 18 18 90 91 91 18 18 18 18 18 18 16 18 18 57 56 56 58 18 18 18 18 31 18 18 18 71 20 6 27 27 27 27 18 18 18 18 18 18 18 18 18 18 18 18 18 18 18 18 18 18 18 18 18 18 18 18 18 18 18 18 18 18 18 18 18 18 18 18 18 18 18 18 18 18 18 18 18 18 18 18 18 18 18 24 29 29 29 6 27 27 27 27 
27 27 27 27 5 29 25 18 18 91 90 90 90 18 18 18 17 17 18 18 31 53 54 54 55 18 18 18 18 18 18 18 71 20 66 11 27 27 27 27 18 18 18 18 18 18 18 18 18 18 18 18 18 18 18 18 57 56 56 56 56 56 56 56 58 18 18 18 18 18 18 18 18 18 18 18 18 18 18 18 18 18 18 18 18 18 18 18 18 18 18 24 29 29 29 6 27 27 27 27 
27 27 27 27 12 67 21 70 18 18 91 91 91 18 90 90 15 17 18 18 18 47 46 51 55 18 18 16 18 18 71 26 20 66 11 27 27 27 27 27 18 18 18 18 18 18 18 18 18 18 18 18 18 18 18 57 49 54 54 54 54 59 54 54 50 58 18 18 18 18 18 18 18 18 18 18 18 18 18 18 18 18 18 18 18 18 18 18 18 18 18 24 29 29 29 6 27 27 27 27 
27 27 27 27 27 5 29 21 70 18 17 18 90 90 91 91 17 18 90 90 18 18 15 47 48 32 18 18 71 26 20 66 7 11 27 27 27 27 27 27 18 18 18 18 18 18 18 18 18 18 18 18 57 56 56 49 52 46 46 46 46 46 46 51 54 54 58 18 18 18 18 18 18 18 18 18 18 18 18 18 18 18 18 18 18 18 18 18 18 18 18 24 29 29 29 6 27 27 27 27 
27 27 27 27 27 27 67 29 21 70 18 18 91 91 90 90 90 90 91 91 18 18 18 18 18 18 18 18 24 66 7 11 27 27 27 27 27 27 27 27 18 18 18 18 18 18 18 18 18 18 18 57 49 54 52 46 48 18 18 18 17 18 17 47 51 59 55 18 18 18 18 18 18 18 18 18 18 18 18 18 18 18 18 18 18 18 18 18 18 18 18 24 29 29 29 6 27 27 27 27 
27 27 27 27 27 27 12 67 29 21 70 18 18 18 91 91 91 91 18 18 18 18 18 17 18 18 18 71 20 6 27 27 27 27 27 27 27 27 27 27 18 18 18 18 18 18 18 18 18 18 57 49 52 46 48 17 18 18 18 33 18 18 17 17 47 51 50 56 58 18 18 18 18 18 18 18 18 18 18 18 18 18 18 18 18 18 18 18 18 18 18 24 29 29 29 6 27 27 27 27 
27 27 27 27 27 27 27 12 7 67 21 26 26 70 18 18 18 18 18 18 18 17 17 17 18 18 71 20 66 11 27 27 27 27 27 27 27 27 27 27 18 18 18 18 18 18 18 18 18 57 49 54 55 18 18 18 18 18 18 18 18 18 18 18 18 47 51 54 55 18 18 18 18 18 18 18 18 18 18 18 18 18 18 18 18 18 18 18 18 18 18 24 29 29 29 6 27 27 27 27 
27 27 27 27 27 27 27 27 27 12 7 67 29 21 26 70 18 18 18 18 18 18 17 18 18 71 20 66 11 27 27 27 27 27 27 27 27 27 27 27 18 18 18 18 18 18 18 18 57 49 54 59 55 18 33 18 18 18 18 18 18 18 18 18 18 18 47 51 50 56 58 18 18 18 18 18 18 18 18 18 18 18 18 18 18 18 18 18 18 18 18 24 29 29 29 6 27 27 27 27 
27 27 27 27 27 27 27 27 27 27 27 12 7 7 67 21 70 18 18 18 18 18 18 18 71 20 66 11 27 27 27 27 27 27 27 27 27 27 27 27 18 18 18 18 18 18 18 57 49 52 46 46 48 17 18 18 18 18 18 18 18 18 18 18 18 18 18 47 51 59 55 18 18 18 18 18 18 18 18 18 18 18 18 18 18 18 18 18 18 18 18 24 29 29 29 6 27 27 27 27 
27 27 27 27 27 27 27 27 27 27 27 27 27 27 5 29 21 26 26 26 26 26 26 26 20 66 11 27 27 27 27 27 27 27 27 27 27 27 27 27 18 18 18 18 18 18 57 49 52 48 18 17 18 18 18 18 18 73 72 71 32 18 32 18 18 18 18 18 53 54 55 18 18 18 18 18 18 18 18 18 18 18 18 18 18 18 18 18 18 18 18 24 29 29 29 6 27 27 27 27 
27 27 27 27 27 27 27 27 27 27 27 27 27 27 12 67 29 29 34 66 7 7 7 7 7 11 27 27 27 27 27 27 27 27 27 27 27 27 27 27 18 18 18 18 18 18 53 54 55 18 18 35 64 18 17 17 18 81 80 79 17 17 18 18 18 18 18 17 47 51 50 58 18 18 18 18 18 18 18 18 18 18 18 18 18 18 18 18 18 18 18 24 29 29 29 6 27 27 27 27 
27 27 27 27 27 27 27 27 27 27 27 27 27 27 27 12 7 7 7 11 27 27 27 27 27 27 27 27 27 27 27 27 27 27 27 27 27 27 27 27 18 18 18 18 18 57 49 52 48 18 18 18 33 18 18 17 18 78 77 76 18 35 18 18 18 18 18 18 18 53 59 55 18 18 18 18 18 18 18 18 18 18 18 18 18 18 18 18 18 18 18 24 29 29 29 6 27 27 27 27 
27 27 27 27 27 27 27 27 27 27 27 27 27 27 27 27 27 27 27 27 27 27 27 27 27 27 27 27 27 27 27 27 27 27 27 27 27 27 27 27 18 18 18 18 18 53 54 55 18 18 17 18 18 18 18 18 16 75 74 70 15 17 18 18 18 18 18 18 18 53 52 48 18 18 18 18 18 18 18 18 18 18 18 18 18 18 18 18 18 18 18 24 29 29 29 6 27 27 27 27 
27 27 27 27 27 29 29 29 25 18 18 18 18 27 27 27 27 18 18 18 18 18 18 18 18 18 18 18 18 18 18 18 18 18 18 18 18 18 18 18 18 18 18 18 57 49 59 55 18 18 18 18 18 17 17 18 18 15 28 16 18 18 18 18 18 18 18 18 18 53 55 18 18 18 18 18 18 18 18 18 18 18 18 18 18 18 18 18 18 18 18 24 29 29 29 6 27 27 27 27 
27 27 27 27 27 27 27 27 25 18 27 27 27 27 18 18 18 18 18 18 18 18 18 18 18 18 18 18 18 18 18 18 18 18 18 18 18 18 18 18 18 18 18 18 53 54 54 55 17 18 33 18 18 17 17 18 18 17 28 18 18 18 18 17 18 18 18 57 56 49 55 18 18 18 18 18 18 18 18 18 18 18 18 18 18 18 18 18 18 18 18 24 29 29 29 6 27 27 27 27 
27 27 27 27 5 29 29 27 27 27 27 18 18 18 18 18 18 18 18 18 18 18 18 18 18 18 18 18 18 18 18 18 18 18 18 18 18 18 18 18 18 18 18 18 53 54 54 55 18 18 18 18 18 18 18 18 18 31 14 31 18 17 18 68 69 18 57 54 59 52 48 18 18 18 18 18 18 18 18 18 18 18 18 18 18 18 18 18 18 18 18 24 29 29 29 6 27 27 27 27 
27 27 27 27 5 29 29 29 25 18 18 18 18 18 18 18 18 18 18 18 18 18 57 56 56 56 58 18 18 18 18 18 18 18 18 18 18 18 18 18 18 18 18 18 53 59 54 50 58 18 17 18 18 18 18 18 18 57 14 56 58 18 17 66 67 18 53 54 52 48 18 18 18 18 18 18 18 18 18 18 18 18 18 18 18 18 18 18 18 18 18 24 29 29 29 6 27 27 27 27 
27 27 27 27 5 29 29 29 25 18 18 18 18 18 18 18 57 58 18 18 18 57 54 54 54 54 50 58 18 18 18 18 18 18 18 18 18 18 18 18 18 18 18 18 47 54 54 59 50 56 56 58 18 17 18 57 56 49 14 54 50 58 17 18 18 57 49 52 48 18 18 18 18 18 18 18 18 18 18 18 18 18 18 18 18 18 18 18 18 18 18 24 29 29 29 6 27 27 27 27 
27 27 27 27 5 29 29 29 25 18 18 18 18 18 18 57 54 50 56 56 56 49 54 59 54 54 54 55 18 18 18 18 18 18 18 18 18 18 18 18 18 18 18 18 18 47 46 46 46 51 54 55 18 18 57 49 59 59 14 59 59 50 56 56 56 49 59 55 18 18 18 18 18 18 18 18 18 18 18 18 18 18 18 18 18 18 18 18 18 18 18 24 29 29 29 6 27 27 27 27 
27 27 27 27 5 29 29 29 25 18 18 18 18 18 18 47 46 51 54 54 54 54 59 54 54 54 54 48 18 18 18 18 18 18 18 18 18 18 18 18 18 18 18 18 18 18 18 18 18 47 51 50 56 56 49 52 46 46 14 46 46 46 46 46 46 46 51 55 18 18 18 18 18 18 18 18 18 18 18 18 18 18 18 18 18 18 18 18 18 18 18 24 29 29 29 6 27 27 27 27 
27 27 27 27 5 29 29 29 25 18 18 18 18 18 18 18 18 53 54 54 59 54 54 54 54 54 48 18 18 18 18 18 18 18 18 18 18 18 18 18 18 18 18 18 18 18 18 18 18 18 47 46 46 46 46 48 17 32 14 32 18 18 18 18 18 18 47 48 18 18 18 18 18 18 18 18 18 18 18 18 18 18 18 18 18 18 18 18 18 18 18 24 29 29 29 6 27 27 27 27 
27 27 27 27 5 29 29 29 25 18 18 18 18 18 18 18 18 53 54 54 59 54 59 54 54 48 18 18 18 18 18 18 18 18 18 18 18 18 18 18 18 18 18 18 18 18 18 18 18 18 18 18 18 18 18 33 18 15 28 16 18 33 18 18 18 18 18 18 18 18 18 18 18 18 18 18 18 18 18 18 18 18 18 18 18 18 18 18 18 18 18 24 29 29 29 6 27 27 27 27 
27 27 27 27 5 29 29 29 25 18 18 18 18 18 18 18 18 53 54 59 54 54 54 54 48 18 18 18 18 18 18 18 18 18 18 18 18 18 18 18 18 18 18 18 18 18 18 18 18 18 18 18 18 18 18 18 18 32 28 32 17 18 18 18 17 17 18 18 18 18 18 18 18 18 18 18 18 18 18 18 18 18 18 18 18 18 18 18 18 18 18 24 29 29 29 6 27 27 27 27 
27 27 27 27 5 29 29 29 25 18 18 18 18 18 18 18 18 47 54 54 52 46 46 48 18 18 18 18 18 18 18 18 18 18 18 18 18 18 18 18 18 18 18 18 18 18 18 18 18 18 17 18 18 17 18 33 18 16 28 15 18 33 18 18 17 17 17 18 18 18 18 18 18 18 18 18 18 18 18 18 18 18 18 18 18 18 18 18 18 18 18 24 29 29 29 6 27 27 27 27 
27 27 27 27 5 29 29 29 25 18 18 18 18 18 18 18 18 18 47 46 48 18 18 18 18 18 18 18 18 18 18 18 18 18 18 18 18 18 18 18 18 18 18 18 18 18 18 18 18 18 17 17 18 18 18 18 18 32 28 32 18 18 18 18 18 18 18 18 18 18 18 18 18 18 18 18 18 18 18 18 18 18 18 18 18 18 18 18 18 18 18 24 29 29 29 6 27 27 27 27 
27 27 27 27 5 29 29 29 25 18 18 18 18 18 18 18 18 18 18 18 18 18 18 18 18 18 18 18 18 18 18 18 18 18 18 18 18 18 18 18 17 17 17 17 17 18 17 18 18 18 18 17 18 18 18 28 28 28 28 28 28 28 17 18 18 18 18 18 18 18 31 31 18 18 35 18 18 18 18 18 18 18 18 18 18 18 18 18 18 18 18 24 29 29 29 6 27 27 27 27 
27 27 27 27 5 29 29 29 25 18 18 18 18 18 18 18 18 18 18 18 18 18 18 18 18 18 18 18 18 18 18 18 18 18 18 18 18 18 18 18 17 18 18 18 18 18 18 18 31 32 31 32 31 32 35 28 28 28 28 28 28 28 17 17 17 18 18 18 18 31 31 18 18 18 18 18 18 18 18 18 18 18 18 18 18 18 18 18 18 18 18 24 29 29 29 6 27 27 27 27 
27 27 27 27 5 29 29 29 25 18 18 18 18 18 18 18 18 18 18 18 18 18 18 18 18 18 18 18 18 18 18 18 18 18 18 18 18 18 18 18 18 18 18 18 18 18 18 18 28 28 28 28 28 28 28 28 28 28 28 28 28 28 18 18 18 18 18 18 18 18 57 56 56 58 32 18 18 18 18 18 18 18 18 18 18 18 18 18 18 18 18 24 29 29 29 6 27 27 27 27 
27 27 27 27 5 29 29 29 25 18 18 18 18 18 18 18 18 18 18 18 18 18 18 18 18 18 18 18 18 18 18 18 18 18 18 18 18 18 18 18 18 18 18 18 17 17 17 18 31 32 31 32 31 32 35 28 28 28 28 28 28 28 18 18 18 18 18 18 18 57 54 54 54 54 58 18 18 18 18 18 18 18 18 18 18 18 18 18 18 18 18 24 29 29 29 6 27 27 27 27 
27 27 27 27 5 29 29 29 25 18 18 18 18 18 18 18 18 18 18 18 18 18 18 18 18 18 18 18 18 18 18 18 18 18 18 18 18 18 18 18 18 57 56 56 56 56 56 56 56 56 56 58 18 18 18 28 28 28 28 28 28 28 18 18 18 18 18 18 18 47 51 54 54 54 55 18 18 18 18 18 18 18 18 18 18 18 18 18 18 18 18 24 29 29 29 6 27 27 27 27 
27 27 27 27 5 29 29 29 25 18 18 18 18 18 18 18 18 18 18 18 18 18 18 18 18 18 18 18 18 18 18 18 18 18 18 18 18 18 18 18 57 49 54 54 54 52 46 46 46 46 46 48 18 18 18 32 31 32 28 32 31 32 18 17 18 18 18 18 18 18 53 54 54 54 55 32 18 18 18 18 18 18 18 18 18 18 18 18 18 18 18 24 29 29 29 6 27 27 27 27 
27 27 27 27 5 29 29 29 25 18 18 18 18 18 18 18 18 18 18 18 18 18 18 18 18 18 18 18 18 18 18 18 18 18 18 18 18 18 18 18 47 46 46 54 52 48 18 18 18 18 18 18 18 18 18 18 18 18 28 18 18 18 18 17 17 17 18 18 18 18 47 46 46 46 48 31 32 18 18 18 18 18 18 18 18 18 18 18 18 18 18 24 29 29 29 6 27 27 27 27 
27 27 27 27 5 29 29 29 25 18 18 18 18 18 18 18 18 18 18 18 18 18 18 18 18 18 18 18 18 18 18 18 18 18 18 18 18 18 18 18 18 18 18 47 48 18 18 17 17 17 17 17 18 18 18 18 18 31 28 31 18 18 18 18 18 17 17 17 18 18 18 18 18 18 18 31 32 18 18 18 18 18 18 18 18 18 18 18 18 18 18 24 29 29 29 6 27 27 27 27 
27 27 27 27 5 29 29 29 25 18 18 18 18 18 18 18 18 18 18 18 18 18 18 18 18 18 18 18 18 18 18 18 18 18 18 18 18 18 18 18 18 18 18 18 18 18 18 18 17 18 18 18 18 18 18 18 18 18 28 18 18 18 18 18 18 18 18 17 18 18 18 18 18 18 18 18 18 18 18 18 18 18 18 18 18 18 18 18 18 18 18 24 29 29 29 6 27 27 27 27 
27 27 27 27 5 29 29 29 25 18 18 18 18 18 18 18 18 18 18 18 18 18 18 18 18 18 18 18 18 18 18 18 18 18 18 18 18 18 18 18 18 18 18 18 18 18 18 18 18 18 18 18 18 18 63 26 26 26 28 26 26 26 26 26 26 62 18 18 18 18 18 18 18 18 18 18 18 18 18 18 18 18 18 18 18 18 18 18 18 18 18 24 29 29 29 6 27 27 27 27 
27 27 27 27 5 29 29 29 25 18 18 18 18 18 18 18 18 18 18 18 18 18 18 18 18 18 18 18 18 18 18 18 18 18 18 18 18 18 18 18 18 18 18 18 18 18 18 18 18 18 18 18 18 18 24 29 29 29 29 29 29 29 34 34 29 25 18 18 18 18 18 18 18 18 18 18 18 18 18 18 18 18 18 18 18 18 18 18 18 18 18 24 29 29 29 6 27 27 27 27 
27 27 27 27 5 29 29 29 25 18 18 18 18 18 18 18 18 18 18 18 18 18 18 18 18 18 18 18 18 18 18 18 18 18 18 18 18 18 18 18 18 18 18 18 18 18 18 18 18 18 18 18 18 18 24 29 29 29 29 29 29 29 29 34 29 25 18 18 18 18 18 18 18 18 18 18 18 18 18 18 18 18 18 18 18 18 18 18 18 18 18 24 29 29 29 6 27 27 27 27 
27 27 27 27 5 29 29 29 25 18 18 18 18 18 18 18 18 18 18 18 18 18 18 18 18 18 18 18 18 18 18 18 18 18 18 18 18 18 18 18 18 18 18 18 18 18 18 18 18 17 18 18 18 18 24 29 29 29 34 29 29 29 29 29 29 25 18 18 18 18 18 18 18 18 18 18 18 18 18 18 18 18 18 18 18 18 18 18 18 18 18 24 29 29 29 6 27 27 27 27 
27 27 27 27 5 29 29 29 25 18 18 18 18 18 18 18 18 18 18 18 18 18 18 18 18 18 18 18 18 18 18 18 18 18 18 18 18 18 18 18 18 18 18 18 18 18 18 17 17 17 17 18 18 18 24 29 29 29 34 29 29 29 29 29 29 25 18 18 18 18 18 18 18 18 18 18 18 18 18 18 18 18 18 18 18 18 18 18 18 18 18 24 29 29 29 6 27 27 27 27 
27 27 27 27 5 29 29 29 25 18 18 18 18 18 18 18 18 18 18 18 18 18 18 18 18 18 18 18 18 18 18 18 18 18 18 18 18 18 18 18 18 18 18 18 18 18 18 17 17 18 18 18 18 18 24 29 34 29 29 29 29 29 29 34 29 25 18 18 18 18 18 18 18 18 18 18 18 18 18 18 18 18 18 18 18 18 18 18 18 18 18 24 29 29 29 6 27 27 27 27 
27 27 27 27 5 29 29 29 25 18 18 18 18 18 18 18 18 18 18 18 18 18 18 18 18 18 18 18 18 18 18 18 18 18 18 18 18 18 18 18 18 18 18 18 18 18 18 18 17 18 18 18 18 18 24 29 29 29 29 29 29 29 29 29 29 25 18 18 18 18 18 18 18 18 18 18 18 18 18 18 18 18 18 18 18 18 18 18 18 18 18 24 29 29 29 6 27 27 27 27 
27 27 27 27 5 29 29 29 25 18 18 18 18 18 18 18 18 18 18 18 18 18 18 18 18 18 18 18 18 18 18 18 18 18 18 18 18 18 18 18 18 18 18 18 18 18 18 18 18 18 18 18 18 18 24 29 34 29 29 29 29 29 29 29 29 25 18 18 18 18 17 18 18 18 18 18 18 18 18 18 18 18 18 18 18 18 18 18 18 18 18 24 29 29 29 6 27 27 27 27 
27 27 27 27 5 29 29 29 25 18 18 18 18 18 18 18 18 18 18 18 18 18 18 18 18 18 18 18 18 18 18 18 18 18 18 18 18 18 18 18 18 18 18 18 18 18 17 18 18 18 18 18 18 18 24 29 34 34 29 29 29 29 29 34 29 25 18 18 17 17 17 18 18 18 18 18 18 18 18 18 18 18 18 18 18 18 18 18 18 18 18 24 29 29 29 6 27 27 27 27 
27 27 27 27 5 29 29 29 25 18 18 18 18 18 18 18 18 18 18 18 18 18 18 18 18 18 18 18 18 18 18 18 18 18 18 18 18 18 18 18 18 18 18 18 18 18 17 17 17 17 18 18 18 18 24 29 29 29 29 29 29 29 29 29 29 25 18 17 17 18 17 17 18 18 18 18 18 18 18 18 18 18 18 18 18 18 18 18 18 18 18 24 29 29 29 6 27 27 27 27 
27 27 27 27 5 29 29 29 25 18 18 18 18 18 18 18 18 18 18 18 18 18 18 18 18 18 18 18 18 18 18 18 18 18 18 18 18 18 18 18 18 18 18 18 18 18 18 18 17 17 17 18 18 18 60 19 19 19 19 19 19 19 19 19 19 61 18 18 17 17 17 17 18 18 18 18 18 18 18 18 18 18 18 18 18 18 18 18 18 18 18 24 29 29 29 6 27 27 27 27 
27 27 27 27 5 29 29 29 25 18 18 18 18 18 18 18 18 18 18 18 18 18 18 18 18 18 18 18 18 18 18 18 18 18 18 18 18 18 18 18 18 18 18 18 18 18 18 18 17 18 17 17 18 18 18 18 18 18 18 18 18 18 18 18 18 18 18 18 18 18 18 18 18 18 18 18 18 18 18 18 18 18 18 18 18 18 18 18 18 18 18 24 29 29 29 6 27 27 27 27 
27 27 27 27 5 29 29 29 25 18 18 18 18 18 18 18 18 18 18 18 18 18 18 18 18 18 18 18 18 18 18 18 18 18 18 18 18 18 18 18 18 18 18 18 18 18 18 18 17 17 17 17 18 18 18 18 17 18 18 18 18 18 18 18 18 18 18 18 18 18 18 18 18 18 18 18 18 18 18 18 18 18 18 18 18 18 18 18 18 18 18 24 29 29 29 6 27 27 27 27 
27 27 27 27 5 29 29 29 25 18 18 18 18 18 18 18 18 18 18 18 18 18 18 18 18 18 18 18 18 18 18 18 18 18 18 18 18 18 18 18 18 18 18 18 18 18 18 18 18 17 17 18 18 18 18 18 18 18 18 18 18 17 17 17 18 18 17 18 18 18 18 18 18 18 18 18 18 18 18 18 18 18 18 18 18 18 18 18 18 18 18 24 29 29 29 6 27 27 27 27 
27 27 27 27 5 29 29 29 25 18 18 18 18 18 18 18 18 18 18 18 18 18 18 18 18 18 18 18 18 18 18 18 18 18 18 18 18 18 18 18 18 18 18 18 18 18 18 18 18 18 18 18 18 18 18 18 18 18 18 17 18 18 18 18 18 18 18 18 18 18 18 18 18 18 18 18 18 18 18 18 18 18 18 18 18 18 18 18 18 18 18 24 29 29 29 6 27 27 27 27 
27 27 27 27 5 29 29 29 25 18 18 18 18 18 18 18 18 18 18 18 18 18 18 18 18 18 18 18 18 18 18 18 18 18 18 18 18 18 18 18 18 18 18 18 18 18 18 18 18 18 18 18 18 18 18 18 18 18 18 17 18 18 18 18 18 18 18 18 18 18 18 18 18 18 18 18 18 18 18 18 18 18 18 18 18 18 18 18 18 18 18 24 29 29 29 6 27 27 27 27 
27 27 27 27 5 29 29 29 25 18 18 18 18 18 18 18 18 18 18 18 18 18 18 18 18 18 18 18 18 18 18 18 18 18 18 18 18 18 18 18 18 18 18 18 18 18 18 18 18 18 18 18 18 18 18 18 18 18 18 18 18 18 18 18 18 18 18 18 18 18 18 18 18 18 18 18 18 18 18 18 18 18 18 18 18 18 18 18 18 18 18 24 29 29 29 6 27 27 27 27 
27 27 27 27 5 29 29 29 25 18 18 18 18 18 18 18 18 18 18 18 18 18 18 18 18 18 18 18 18 18 18 18 18 18 18 18 18 18 18 18 18 18 18 18 18 18 18 18 18 18 18 18 18 18 18 18 18 18 18 18 18 18 18 18 18 18 18 18 18 18 18 18 18 18 18 18 18 18 18 18 18 18 18 18 18 18 18 18 18 18 18 24 29 29 29 6 27 27 27 27 
27 27 27 27 5 29 29 29 25 18 18 18 18 18 18 18 18 18 18 18 18 18 18 18 18 18 18 18 18 18 18 18 18 18 18 18 18 18 18 18 18 18 18 18 18 18 18 18 18 18 18 18 18 18 18 18 18 18 18 18 18 18 18 18 18 18 18 18 18 18 18 18 18 18 18 18 18 18 18 18 18 18 18 18 18 18 18 18 18 18 18 24 29 29 29 6 27 27 27 27 
27 27 27 27 5 29 29 29 25 18 18 18 18 18 18 18 18 18 18 18 18 18 18 18 18 18 18 18 18 18 18 18 18 18 18 18 18 18 18 18 18 18 18 18 18 18 18 18 18 18 18 18 18 18 18 18 18 18 18 18 18 18 18 18 18 18 18 18 18 18 18 18 18 18 18 18 18 18 18 18 18 18 18 18 18 18 18 18 18 18 18 24 29 29 29 6 27 27 27 27 
27 27 27 27 5 29 29 29 25 18 18 18 18 18 18 18 18 18 18 18 18 18 18 18 18 18 18 18 18 18 18 18 18 18 18 18 18 18 18 18 18 18 18 18 18 18 18 18 18 18 18 18 18 18 18 18 18 18 18 18 18 18 18 18 18 18 18 18 18 18 18 18 18 18 18 18 18 18 18 18 18 18 18 18 18 18 18 18 18 18 18 24 29 29 29 6 27 27 27 27 
27 27 27 27 5 29 29 29 25 18 18 18 18 18 18 18 18 18 18 18 18 18 18 18 18 18 18 18 18 18 18 18 18 18 18 18 18 18 18 18 18 18 18 18 18 18 18 18 18 18 18 18 18 18 18 18 18 18 18 18 18 18 18 18 18 18 18 18 18 18 18 18 18 18 18 18 18 18 18 18 18 18 18 18 18 18 18 18 18 18 18 24 29 29 29 6 27 27 27 27 
27 27 27 27 5 29 29 29 25 18 18 18 18 18 18 18 18 18 18 18 18 18 18 18 18 18 18 18 18 18 18 18 18 18 18 18 18 18 18 18 18 18 18 18 18 18 18 18 18 18 18 18 18 18 18 18 18 18 18 18 18 18 18 18 18 18 18 18 18 18 18 18 18 18 18 18 18 18 18 18 18 18 18 18 18 18 18 18 18 18 18 24 29 29 29 6 27 27 27 27 
27 27 27 27 5 29 29 29 25 18 18 18 18 18 18 18 18 18 18 18 18 18 18 18 18 18 18 18 18 18 18 18 18 18 18 18 18 18 18 18 18 18 18 18 18 18 18 18 18 18 18 18 18 18 18 18 18 18 18 18 18 18 18 18 18 18 18 18 18 18 18 18 18 18 18 18 18 18 18 18 18 18 18 18 18 18 18 18 18 18 18 24 29 29 29 6 27 27 27 27 
27 27 27 27 5 29 29 29 25 18 18 18 18 18 18 18 18 18 18 18 18 18 18 18 18 18 18 18 18 18 18 18 18 18 18 18 18 18 18 18 18 18 18 18 18 18 18 18 18 18 18 18 18 18 18 18 18 18 18 18 18 18 18 18 18 18 18 18 18 18 18 18 18 18 18 18 18 18 18 18 18 18 18 18 18 18 18 18 18 18 18 24 29 29 29 6 27 27 27 27 
27 27 27 27 5 29 29 29 25 18 18 18 18 18 18 18 18 18 18 18 18 18 18 18 18 18 18 18 18 18 18 18 18 18 18 18 18 18 18 18 18 18 18 18 18 18 18 18 18 18 18 18 18 18 18 18 18 18 18 18 18 18 18 18 18 18 18 18 18 18 18 18 18 18 18 18 18 18 18 18 18 18 18 18 18 18 18 18 18 18 18 24 29 29 29 6 27 27 27 27 
27 27 27 27 5 29 29 29 25 18 18 18 18 18 18 18 18 18 18 18 18 18 18 18 18 18 18 18 18 18 18 18 18 18 18 18 18 18 18 18 18 18 18 18 18 18 18 18 18 18 18 18 18 18 18 18 18 18 18 18 18 18 18 18 18 18 18 18 18 18 18 18 18 18 18 18 18 18 18 18 18 18 18 18 18 18 18 18 18 18 18 24 29 29 29 6 27 27 27 27 
27 27 27 27 5 29 29 29 25 18 18 18 18 18 18 18 18 18 18 18 18 18 18 18 18 18 18 18 18 18 18 18 18 18 18 18 18 18 18 18 18 18 18 18 18 18 18 18 18 18 18 18 18 18 18 18 18 18 18 18 18 18 18 18 18 18 18 18 18 18 18 18 18 18 18 18 18 18 18 18 18 18 18 18 18 18 18 18 18 18 18 24 29 29 29 6 27 27 27 27 
27 27 27 27 5 29 29 29 25 18 18 18 18 18 18 18 18 18 18 18 18 18 18 18 18 18 18 18 18 18 18 18 18 18 18 18 18 18 18 18 18 18 18 18 18 18 18 18 18 18 18 18 18 18 18 18 18 18 18 18 18 18 18 18 18 18 18 18 18 18 18 18 18 18 18 18 18 18 18 18 18 18 18 18 18 18 18 18 18 18 18 24 29 29 29 6 27 27 27 27 
27 27 27 27 5 29 29 29 25 18 18 18 18 18 18 18 18 18 18 18 18 18 18 18 18 18 18 18 18 18 18 18 18 18 18 18 18 18 18 18 18 18 18 18 18 18 18 18 18 18 18 18 18 18 18 18 18 18 18 18 18 18 18 18 18 18 18 18 18 18 18 18 18 18 18 18 18 18 18 18 18 18 18 18 18 18 18 18 18 18 18 24 29 29 29 6 27 27 27 27 
27 27 27 27 5 29 29 29 25 18 18 18 18 18 18 18 18 18 18 18 18 18 18 18 18 18 18 18 18 18 18 18 18 18 18 18 18 18 18 18 18 18 18 18 18 18 18 18 18 18 18 18 18 18 18 18 18 18 18 18 18 18 18 18 18 18 18 18 18 18 18 18 18 18 18 18 18 18 18 18 18 18 18 18 18 18 18 18 18 18 18 24 29 29 29 6 27 27 27 27 
27 27 27 27 5 29 29 29 25 18 18 18 18 18 18 18 18 18 18 18 18 18 18 18 18 18 18 18 18 18 18 18 18 18 18 18 18 18 18 18 18 18 18 18 18 18 18 18 18 18 18 18 18 18 18 18 18 18 18 18 18 18 18 18 18 18 18 18 18 18 18 18 18 18 18 18 18 18 18 18 18 18 18 18 18 18 18 18 18 18 18 24 29 29 29 6 27 27 27 27 
27 27 27 27 5 29 29 29 25 18 18 18 18 18 18 18 18 18 18 18 18 18 18 18 18 18 18 18 18 18 18 18 18 18 18 18 18 18 18 18 18 18 18 18 18 18 18 18 18 18 18 18 18 18 18 18 18 18 18 18 18 18 18 18 18 18 18 18 18 18 18 18 18 18 18 18 18 18 18 18 18 18 18 18 18 18 18 18 18 18 18 24 29 29 29 6 27 27 27 27 
27 27 27 27 5 29 29 29 25 18 18 18 18 18 18 18 18 18 18 18 18 18 18 18 18 18 18 18 18 18 18 18 18 18 18 18 18 18 18 18 18 18 18 18 18 18 18 18 18 18 18 18 18 18 18 18 18 18 18 18 18 18 18 18 18 18 18 18 18 18 18 18 18 18 18 18 18 18 18 18 18 18 18 18 18 18 18 18 18 18 18 24 29 29 29 6 27 27 27 27 
27 27 27 27 5 29 29 29 25 18 18 18 18 18 18 18 18 18 18 18 18 18 18 18 18 18 18 18 18 18 18 18 18 18 18 18 18 18 18 18 18 18 18 18 18 18 18 18 18 18 18 18 18 18 18 18 18 18 18 18 18 18 18 18 18 18 18 18 18 18 18 18 18 18 18 18 18 18 18 18 18 18 18 18 18 18 18 18 18 18 18 24 29 29 29 6 27 27 27 27 
27 27 27 27 5 29 29 29 25 18 18 18 18 18 18 18 18 18 18 18 18 18 18 18 18 18 18 18 18 18 18 18 18 18 18 18 18 18 18 18 18 18 18 18 18 18 18 18 18 18 18 18 18 18 18 18 18 18 18 18 18 18 18 18 18 18 18 18 18 18 18 18 18 18 18 18 18 18 18 18 18 18 18 18 18 18 18 18 18 18 18 24 29 29 29 6 27 27 27 27 
27 27 27 27 5 29 29 29 21 26 26 26 26 26 26 26 26 26 26 26 26 26 26 26 26 26 26 26 26 26 26 26 26 26 26 26 26 26 26 26 26 26 26 26 26 26 26 26 26 26 26 26 26 26 26 26 26 26 26 26 26 26 26 26 26 26 26 26 26 26 26 26 26 26 26 26 26 26 26 26 26 26 26 26 26 26 26 26 26 26 26 20 29 29 29 6 27 27 27 27 
27 27 27 27 5 29 29 29 29 29 29 29 29 29 29 29 29 29 29 29 29 29 29 29 29 29 29 29 29 29 29 29 29 29 29 29 34 29 29 29 29 29 29 29 29 29 29 29 29 29 29 29 29 29 29 29 29 29 34 29 29 29 29 29 29 29 29 29 29 29 29 29 29 29 29 29 29 29 29 29 29 29 29 29 29 29 29 29 29 29 29 29 29 29 29 6 27 27 27 27 
27 27 27 27 5 29 29 29 29 29 29 29 29 29 29 29 29 29 29 29 29 29 29 29 29 29 29 29 29 29 29 29 29 29 29 29 29 29 29 29 34 29 29 29 29 29 29 29 29 29 29 29 29 29 29 29 29 29 29 29 29 29 29 29 29 29 29 29 29 29 29 34 29 29 29 29 29 29 29 29 29 29 29 29 29 29 29 29 29 29 29 29 29 29 29 6 27 27 27 27 
27 27 27 27 5 29 29 29 29 29 29 29 29 29 29 29 29 29 29 29 29 29 29 29 29 29 29 29 29 29 29 29 29 29 29 29 29 29 29 29 29 29 29 29 29 29 29 29 29 29 29 29 29 29 34 29 29 29 29 29 29 29 29 29 29 29 29 29 29 29 29 29 29 29 29 29 29 29 29 29 29 29 29 29 29 29 29 29 29 29 29 29 29 29 29 6 27 27 27 27 
27 27 27 27 12 0 0 0 0 0 0 0 0 0 0 0 0 0 0 0 0 0 0 0 0 0 0 0 0 0 0 0 0 0 0 0 0 0 0 0 0 0 0 0 0 0 0 0 0 0 0 0 0 0 0 0 0 0 0 0 0 0 0 0 7 7 7 7 7 7 7 7 7 7 7 7 7 7 7 7 7 7 7 7 7 7 7 7 7 7 7 7 7 7 7 11 27 27 27 27 
27 27 27 27 27 27 27 27 27 27 27 27 27 27 27 27 27 27 27 27 27 27 27 27 27 27 27 27 27 27 27 27 27 27 27 27 27 27 27 27 27 27 27 27 27 27 27 27 27 27 27 27 27 27 27 27 27 27 27 27 27 27 27 27 27 27 27 27 27 27 27 27 27 27 27 27 27 27 27 27 27 27 27 27 27 27 27 27 27 27 27 27 27 27 27 27 27 27 27 27 
27 27 27 27 27 27 27 27 27 27 27 27 27 27 27 27 27 27 27 27 27 27 27 27 27 27 27 27 27 27 27 27 27 27 27 27 27 27 27 27 27 27 27 27 27 27 27 27 27 27 27 27 27 27 27 27 27 27 27 27 27 27 27 27 27 27 27 27 27 27 27 27 27 27 27 27 27 27 27 27 27 27 27 27 27 27 27 27 27 27 27 27 27 27 27 27 27 27 27 27 
27 27 27 27 27 27 27 27 27 27 27 27 27 27 27 27 27 27 27 27 27 27 27 27 27 27 27 27 27 27 27 27 27 27 27 27 27 27 27 27 27 27 27 27 27 27 27 27 27 27 27 27 27 27 27 27 27 27 27 27 27 27 27 27 27 27 27 27 27 27 27 27 27 27 27 27 27 27 27 27 27 27 27 27 27 27 27 27 27 27 27 27 27 27 27 27 27 27 27 27 
27 27 27 27 27 27 27 27 27 27 27 27 27 27 27 27 27 27 27 27 27 27 27 27 27 27 27 27 27 27 27 27 27 27 27 27 27 27 27 27 27 27 27 27 27 27 27 27 27 27 27 27 27 27 27 27 27 27 27 27 27 27 27 27 27 27 27 27 27 27 27 27 27 27 27 27 27 27 27 27 27 27 27 27 27 27 27 27 27 27 27 27 27 27 27 27 27 27 27 27 
