27 27 27 27 27 27 27 27 27 27 27 27 27 27 27 27 27 27 27 27 27 27 27 27 27 27 27 27 27 27 27 27 27 27 27 27 27 27 27 27 27 27 27 27 27 27 27 27 27 27 27 27 27 27 27 27 27 27 27 27 27 27 27 27 27 27 27 27 27 27 27 27 27 27 27 27 27 27 27 27 27 27 27 27 27 27 27 27 27 27 27 27 27 27 27 27 27 27 27 27 
27 27 27 27 27 27 27 27 27 27 27 27 27 27 27 27 27 27 27 27 27 27 27 27 27 27 27 27 27 27 27 27 27 27 27 27 27 27 27 27 27 27 27 27 27 27 27 27 27 27 27 27 27 27 27 27 27 27 27 27 27 27 27 27 27 27 27 27 27 27 27 27 27 27 27 27 27 27 27 27 27 27 27 27 27 27 27 27 27 27 27 27 27 27 27 27 27 27 27 27 
27 27 27 27 27 27 27 27 27 27 27 27 27 27 27 27 27 27 27 27 27 27 27 27 27 27 27 27 27 27 27 27 27 27 27 27 27 27 27 27 27 27 27 27 27 27 27 27 27 27 27 27 27 27 27 27 27 27 27 27 27 27 27 27 27 27 27 27 27 27 27 27 27 27 27 27 27 27 27 27 27 27 27 27 27 27 27 27 27 27 27 27 27 27 27 27 27 27 27 27 
27 27 27 27 27 27 27 27 27 27 27 27 27 27 27 27 27 27 27 27 27 27 27 27 27 27 27 27 27 27 27 27 27 27 27 27 27 27 27 27 27 27 27 27 27 27 27 27 27 27 27 27 27 27 27 27 27 27 27 27 27 27 27 27 27 27 27 27 27 27 27 27 27 27 27 27 27 27 27 27 27 27 27 27 27 27 27 27 27 27 27 27 27 27 27 27 27 27 27 27 
27 27 27 27 27 27 27 27 27 27 27 27 27 27 27 27 27 27 27 27 27 27 27 27 27 27 27 27 27 27 27 27 27 27 27 27 27 27 27 27 27 27 27 27 27 27 27 27 27 27 27 27 27 27 27 27 27 27 27 27 27 27 27 27 27 27 27 27 27 27 27 27 27 27 27 27 27 27 27 27 27 27 27 27 27 27 27 27 27 27 27 27 27 27 27 27 27 27 27 27 
27 27 27 27 27 27 27 27 27 27 27 27 27 27 27 27 27 27 27 27 27 27 27 27 27 27 27 27 27 27 27 27 27 27 27 27 27 27 27 27 27 27 27 27 27 27 27 27 27 27 27 27 27 27 27 27 27 27 27 27 27 27 27 27 27 27 27 27 27 27 27 27 27 27 27 27 27 27 27 27 27 27 27 27 27 27 27 27 27 27 27 27 27 27 27 27 27 27 27 27 
27 27 27 27 27 27 27 27 27 27 27 27 27 27 27 27 27 27 10 8 8 8 8 8 8 8 8 8 8 8 8 8 8 8 8 9 27 27 27 27 27 27 27 27 27 27 27 27 27 27 27 27 27 27 27 27 27 27 27 27 27 27 27 27 27 27 27 27 27 27 27 27 27 27 27 27 27 27 27 27 27 27 27 27 27 27 27 27 27 27 27 27 27 27 27 27 27 27 27 27 
27 27 27 27 27 27 27 27 27 27 27 27 27 27 27 27 27 27 5 29 29 29 29 29 34 29 29 29 29 29 29 29 29 29 29 64 8 9 27 27 27 27 27 27 27 27 27 27 27 27 27 27 27 27 27 27 27 27 27 27 27 27 27 27 27 27 27 27 27 27 27 27 27 27 27 27 27 27 27 27 27 27 27 27 27 27 27 27 27 27 27 27 27 27 27 27 27 27 27 27 
27 27 27 27 27 27 27 27 27 27 27 27 27 27 27 10 8 8 65 29 29 23 19 19 19 19 19 19 19 19 19 19 19 19 22 29 29 64 8 9 27 27 27 27 27 27 27 27 27 27 27 27 27 27 27 27 27 27 27 27 27 27 27 27 27 27 27 27 27 27 27 27 27 27 27 27 27 27 27 27 27 27 27 27 27 27 27 27 27 27 27 27 27 27 27 27 27 27 27 27 
27 27 27 27 27 27 27 27 27 27 27 27 27 10 8 65 23 19 19 19 19 68 90 90 90 17 90 90 90 90 90 90 90 18 69 19 19 22 29 64 9 27 27 27 27 27 27 27 27 27 27 27 27 27 27 27 27 27 27 27 27 27 27 27 27 27 27 27 27 27 27 27 27 27 27 27 27 27 27 27 27 27 27 27 27 27 27 27 27 27 27 27 27 27 27 27 27 27 27 27 
27 27 27 27 27 27 27 27 27 27 27 10 8 65 23 19 68 18 90 18 90 90 91 91 91 17 91 91 91 91 91 91 91 90 18 18 18 24 29 29 6 27 27 27 27 27 27 27 27 27 27 27 27 27 27 27 27 27 27 27 27 27 27 27 27 27 27 27 27 27 27 27 27 27 27 27 27 27 27 27 27 27 27 27 27 27 27 27 27 27 27 27 27 27 27 27 27 27 27 27 
27 27 27 27 27 27 27 27 27 27 10 65 23 19 68 18 18 90 91 90 91 91 17 17 17 17 90 90 90 90 90 90 90 91 18 18 18 24 34 29 6 27 27 27 27 27 27 27 27 27 27 27 27 27 27 27 27 27 27 27 27 27 27 27 27 27 27 27 27 27 27 27 27 27 27 27 27 27 27 27 27 27 27 27 27 27 27 27 27 27 27 27 27 27 27 27 27 27 27 27 
27 27 27 27 27 27 27 27 27 27 5 23 68 17 17 18 18 91 90 91 18 18 18 32 17 17 91 91 91 91 91 91 91 18 18 18 18 24 29 29 6 27 27 27 27 27 27 27 27 27 27 27 27 27 27 27 27 27 27 27 27 27 27 27 27 27 27 27 27 27 27 27 27 27 27 27 27 27 27 27 27 27 27 27 27 27 27 27 27 27 27 27 27 27 27 27 27 27 27 27 
27 27 27 27 27 27 27 27 27 10 65 25 18 17 18 90 90 90 91 18 18 18 18 18 17 17 17 17 17 17 17 18 18 18 18 18 18 24 34 29 6 27 27 27 27 27 27 27 27 27 100 102 102 102 102 102 102 102 102 102 102 102 102 102 102 102 102 101 27 27 27 27 27 27 27 27 27 27 27 27 27 27 27 27 27 27 27 27 27 27 27 27 27 27 27 27 27 27 27 27 
27 27 27 27 27 27 27 27 27 5 23 68 18 90 90 91 91 91 18 18 18 81 80 79 18 18 18 18 31 18 16 15 16 18 18 32 18 24 29 34 6 27 27 27 27 27 27 27 100 102 17 17 17 17 16 18 90 18 17 17 17 15 17 17 17 17 17 17 102 101 27 27 27 27 27 27 27 27 27 27 27 27 27 27 27 27 27 27 27 27 27 27 27 27 27 27 27 27 27 27 
27 27 27 27 27 27 27 27 10 65 25 18 18 91 91 90 18 18 18 18 18 89 88 87 18 18 18 18 18 18 15 16 15 18 18 18 18 69 22 29 6 27 27 27 27 27 27 100 17 17 17 16 18 18 18 17 91 17 17 18 18 17 17 17 17 90 17 17 17 17 102 101 27 27 27 27 27 27 27 27 27 27 27 27 27 27 27 27 27 27 27 27 27 27 27 27 27 27 27 27 
27 27 27 27 27 27 27 27 5 29 25 18 18 90 90 91 18 18 17 18 18 86 85 84 18 18 18 18 17 17 18 18 17 18 18 18 18 18 24 66 11 27 27 27 27 27 100 17 17 17 18 18 18 18 18 18 18 18 18 18 18 18 18 18 18 91 90 18 17 17 18 18 101 27 27 27 27 27 27 27 27 27 27 27 27 27 27 27 27 27 27 27 27 27 27 27 27 27 27 27 
27 27 27 27 27 27 27 27 5 29 25 18 18 91 91 90 18 31 18 18 18 83 82 78 18 17 18 18 18 17 17 17 32 18 18 18 18 18 24 6 27 27 27 27 27 27 104 17 17 17 18 18 18 18 18 18 18 17 18 18 18 18 18 18 18 18 91 18 18 18 18 18 18 101 27 27 27 27 27 27 27 27 27 27 27 27 27 27 27 27 27 27 27 27 27 27 27 27 27 27 
27 27 27 27 27 27 27 27 5 29 25 90 90 90 90 91 18 18 18 17 18 16 28 15 18 18 18 31 18 18 18 18 18 18 18 18 18 31 24 6 27 27 27 27 27 27 104 17 18 18 18 33 18 18 18 18 18 17 18 18 18 18 18 18 18 18 18 18 18 17 18 17 18 18 101 27 27 27 27 27 27 27 27 27 27 27 27 27 27 27 27 27 27 27 27 27 27 27 27 27 
27 27 27 27 27 27 27 27 5 29 25 91 91 91 91 90 18 18 17 17 18 18 28 18 93 28 28 92 18 18 18 18 18 18 18 18 18 18 24 6 27 27 27 27 27 100 17 17 18 18 18 18 18 90 90 90 18 17 18 18 17 17 17 18 18 18 18 18 17 15 16 16 17 17 18 101 27 27 27 27 27 27 27 27 27 27 27 27 27 27 27 27 27 27 27 27 27 27 27 27 
27 27 27 27 27 27 27 27 5 29 25 90 90 90 90 91 32 18 18 31 18 18 28 31 28 76 77 28 16 18 18 18 18 18 18 18 18 93 37 37 37 37 37 37 37 36 92 18 18 18 18 18 18 91 91 91 18 17 17 18 17 17 93 92 18 18 18 18 17 16 15 17 32 17 18 18 101 27 27 27 27 27 27 27 27 27 27 27 27 27 27 27 27 27 27 27 27 27 27 27 
27 27 27 27 27 27 27 27 5 29 25 91 91 91 91 18 18 18 18 18 18 18 28 28 28 74 75 28 28 28 28 28 28 28 28 28 28 28 14 14 14 14 14 14 14 14 28 28 28 28 28 28 28 28 28 28 28 28 28 28 28 28 28 28 18 18 18 18 18 17 17 32 31 17 18 18 18 101 27 27 27 27 27 27 27 27 27 27 27 27 27 27 27 27 27 27 27 27 27 27 
27 27 27 27 27 27 27 27 5 29 25 90 90 90 18 18 15 18 17 18 32 18 94 28 28 28 28 95 18 17 17 17 17 18 18 18 18 94 37 37 37 37 37 37 37 36 95 18 18 18 18 18 17 17 17 17 17 18 33 18 18 32 28 28 32 18 18 18 18 18 17 17 17 17 18 18 18 103 6 27 27 27 27 27 27 27 27 27 27 27 27 27 27 27 27 27 27 27 27 27 
27 27 27 27 27 27 27 27 5 29 25 91 91 91 90 90 18 18 17 18 18 18 18 18 18 17 17 18 18 17 17 18 18 18 18 18 18 18 24 6 27 27 27 27 5 25 18 18 18 18 18 18 18 18 18 18 18 18 18 18 18 18 28 28 18 18 17 18 18 18 18 18 18 18 18 17 18 18 6 27 27 27 27 27 27 27 27 27 27 27 27 27 27 27 27 27 27 27 27 27 
27 27 27 27 27 27 27 27 5 29 25 18 18 90 91 91 18 18 18 18 18 18 16 18 18 57 56 56 58 18 18 18 18 31 18 18 18 71 20 6 27 27 27 27 5 25 18 18 18 18 18 18 18 18 18 18 17 17 17 17 18 18 28 28 18 18 17 17 17 18 18 18 18 18 17 17 18 18 6 27 27 27 27 27 27 27 27 27 27 27 27 27 27 27 27 27 27 27 27 27 
27 27 27 27 27 27 27 27 5 29 25 18 18 91 90 90 90 18 18 18 17 17 18 18 31 53 54 59 55 18 18 18 18 18 18 18 71 20 66 11 27 27 27 27 5 21 70 33 18 18 18 18 33 18 32 33 17 17 18 18 16 31 28 28 31 18 18 18 17 17 17 32 18 18 18 18 71 20 6 27 27 27 27 27 27 27 27 27 27 27 27 27 27 27 27 27 27 27 27 27 
27 27 27 27 27 27 27 27 12 67 21 70 18 18 91 91 91 18 90 90 15 17 18 18 18 47 46 51 55 18 18 16 18 18 71 26 20 66 11 27 27 27 27 27 5 34 25 18 18 18 18 18 18 18 18 18 18 18 33 18 18 18 28 28 18 18 18 18 18 18 18 18 18 33 18 71 20 66 11 27 27 27 27 27 27 27 27 27 27 27 27 27 27 27 27 27 27 27 27 27 
27 27 27 27 27 27 27 27 27 5 29 21 70 18 17 18 90 90 91 91 17 18 90 90 18 18 15 47 48 32 18 18 71 26 20 66 7 11 27 27 27 27 27 27 5 29 25 18 18 18 18 18 18 18 18 18 18 18 18 18 18 18 28 28 18 18 18 17 17 17 18 18 18 18 18 24 66 11 27 27 27 27 27 27 27 27 27 27 27 27 27 27 27 27 27 27 27 27 27 27 
27 27 27 27 27 27 27 27 27 27 67 29 21 70 18 18 91 91 90 90 90 90 91 91 18 18 18 18 18 18 18 18 24 66 7 11 27 27 27 27 27 27 27 27 5 34 25 18 18 18 18 16 18 33 18 17 17 18 18 18 18 18 28 28 18 18 16 18 18 17 17 18 18 18 18 24 6 27 27 27 27 27 27 27 27 27 27 27 27 27 27 27 27 27 27 27 27 27 27 27 
27 27 27 27 27 27 27 27 27 27 12 67 29 21 70 18 18 18 91 91 91 91 18 18 18 18 18 17 18 18 18 71 20 6 27 27 27 27 27 27 27 27 27 27 5 29 25 18 18 18 18 17 17 16 18 17 17 17 17 17 17 17 28 28 18 18 18 18 18 18 18 18 18 33 18 24 6 27 27 27 27 27 27 27 27 27 27 27 27 27 27 27 27 27 27 27 27 27 27 27 
27 27 27 27 27 27 27 27 27 27 27 12 7 67 21 26 26 70 18 18 18 18 18 18 18 17 17 17 18 18 71 20 66 11 27 27 27 27 27 27 27 27 27 27 5 29 25 18 16 18 18 18 17 17 17 17 17 17 17 17 17 17 28 28 18 18 18 33 18 18 15 18 18 18 18 24 64 8 8 9 27 27 27 27 27 27 27 27 27 27 27 27 27 27 27 27 27 27 27 27 
27 27 27 27 27 27 27 27 27 27 27 27 27 12 7 67 29 21 26 70 18 18 18 18 18 18 17 18 18 71 20 66 11 27 27 27 27 27 27 27 27 27 27 27 5 29 25 18 18 18 18 90 90 90 16 18 90 90 90 15 17 90 28 28 18 18 90 90 90 18 18 90 90 90 18 69 19 19 22 64 8 9 27 27 27 27 27 27 27 27 27 27 27 27 27 27 27 27 27 27 
27 27 27 27 27 27 27 27 27 27 27 27 27 27 27 12 7 7 67 21 70 18 18 18 18 18 18 18 71 20 66 11 27 27 27 27 27 27 27 27 27 27 27 27 5 29 25 18 18 18 18 91 91 91 18 18 91 91 91 18 18 91 28 28 33 18 91 91 91 15 33 91 91 91 18 18 18 18 69 19 22 64 8 8 8 9 27 27 27 27 27 27 27 27 27 27 27 27 27 27 
27 27 27 27 27 27 27 27 27 27 27 27 27 27 27 27 27 27 5 29 21 26 26 26 26 26 26 26 20 66 11 27 27 27 27 27 27 27 27 27 27 27 27 27 5 34 25 18 18 18 18 18 18 18 18 18 57 56 56 58 18 18 28 28 18 18 18 18 18 18 15 16 15 18 18 18 18 33 18 18 69 19 19 19 22 6 27 27 27 27 27 27 27 27 27 27 27 27 27 27 
27 27 27 27 27 27 27 27 27 27 27 27 27 27 27 27 27 27 12 67 29 29 34 66 7 7 7 7 7 11 27 27 27 27 27 27 27 27 27 27 27 27 27 27 5 29 25 18 18 17 17 18 17 17 18 18 53 54 59 55 18 18 28 28 18 18 18 18 18 15 115 116 117 15 18 18 18 18 18 18 18 18 18 18 24 6 27 27 27 27 27 27 27 27 27 27 27 27 27 27 
27 27 27 27 27 27 27 27 27 27 27 27 27 27 27 27 27 27 27 12 7 7 7 11 27 27 27 27 27 27 27 27 27 27 27 27 27 27 27 27 27 27 27 27 5 29 25 18 18 18 90 17 17 18 18 18 47 46 46 48 18 18 28 28 18 18 18 18 18 16 118 119 120 16 90 18 18 18 18 18 18 18 18 18 24 6 27 27 27 27 27 27 27 27 27 27 27 27 27 27 
27 27 27 27 27 27 27 27 27 27 27 27 27 27 27 27 27 27 27 27 27 27 27 27 27 27 27 27 27 27 27 27 27 27 27 27 27 27 27 27 27 27 27 10 65 23 68 18 18 18 91 130 134 135 136 18 18 18 18 18 18 18 28 28 92 18 18 18 18 15 121 122 123 15 91 18 18 18 18 18 18 18 18 18 24 6 27 27 27 27 27 27 27 27 27 27 27 27 27 27 
27 27 27 27 27 27 27 27 27 27 27 27 27 27 27 27 27 27 27 27 27 27 27 27 27 27 27 27 27 27 27 27 27 27 27 27 27 27 27 27 27 27 10 65 23 68 18 18 18 18 90 137 138 139 140 18 17 17 18 18 18 18 28 28 28 28 28 28 28 28 28 28 95 18 18 18 18 18 18 18 18 18 18 18 24 6 27 27 27 27 27 27 27 27 27 27 27 27 27 27 
27 27 27 27 27 27 27 27 27 27 27 27 27 27 27 27 27 27 27 27 27 27 27 27 27 27 27 27 27 27 27 27 27 27 27 27 27 27 27 27 27 10 65 23 68 18 18 18 18 18 91 141 131 132 133 18 18 18 18 18 18 17 28 28 95 18 18 18 18 18 18 18 18 18 18 18 18 18 18 18 18 18 18 18 24 6 27 27 27 27 27 27 27 27 27 27 27 27 27 27 
27 27 27 27 27 27 27 27 27 27 27 27 27 27 27 27 27 27 27 27 27 27 27 27 27 27 27 27 27 27 27 27 27 27 27 27 27 27 27 27 10 65 23 68 18 18 18 18 18 18 18 16 28 28 15 18 18 18 18 18 18 93 28 28 18 18 18 18 32 18 18 18 17 17 17 18 18 17 18 18 18 18 18 18 24 6 27 27 27 27 27 27 27 27 27 27 27 27 27 27 
27 27 27 27 27 27 27 27 27 27 27 27 27 27 27 27 27 27 27 27 27 27 27 27 27 27 27 27 27 27 27 27 27 27 27 27 27 27 27 10 65 29 68 18 18 18 18 18 18 18 18 18 94 28 28 28 28 28 28 28 28 28 28 28 18 18 16 32 90 32 17 18 18 17 18 18 17 18 18 32 18 18 18 18 24 6 27 27 27 27 27 27 27 27 27 27 27 27 27 27 
27 27 27 27 27 27 27 27 27 27 27 27 27 27 27 27 27 27 27 27 27 27 27 27 27 27 27 27 27 27 27 27 27 27 27 27 27 27 10 65 23 68 17 17 18 18 18 18 18 18 18 18 17 17 17 18 18 15 18 18 18 94 28 28 18 16 16 90 91 90 17 18 18 18 18 142 146 147 148 18 18 18 18 71 20 6 27 27 27 27 27 27 27 27 27 27 27 27 27 27 
27 27 27 27 27 27 27 27 27 27 27 27 27 27 27 27 27 27 27 27 27 27 27 27 27 27 27 27 27 27 27 27 27 27 27 27 27 10 65 23 68 18 17 17 17 18 18 18 18 18 18 17 17 18 18 18 18 16 16 16 18 18 28 28 18 18 15 91 90 91 17 17 18 18 18 149 150 151 152 18 15 18 16 24 66 11 27 27 27 27 27 27 27 27 27 27 27 27 27 27 
27 27 27 27 27 27 27 27 27 27 27 27 27 27 27 27 27 27 27 27 27 27 27 27 27 27 27 27 27 27 27 27 27 27 27 27 10 65 23 68 18 18 18 18 18 18 18 18 18 18 18 18 18 18 18 18 18 16 15 15 18 93 28 28 92 18 18 15 91 17 17 17 17 17 17 153 143 144 145 18 18 18 18 24 6 27 27 27 27 27 27 27 27 27 27 27 27 27 27 27 
27 27 27 27 27 27 27 27 27 27 27 27 27 27 27 27 27 27 27 27 27 27 27 27 27 27 27 27 27 27 27 27 27 27 27 27 65 23 68 18 18 18 18 18 18 17 18 18 18 18 18 18 18 18 18 17 17 18 18 18 93 28 28 28 28 28 28 28 28 28 28 28 28 28 28 28 28 95 17 18 18 15 18 24 64 9 27 27 27 27 27 27 27 27 27 27 27 27 27 27 
27 27 27 27 27 27 27 27 27 27 27 27 27 27 27 27 27 27 27 27 27 27 27 27 27 27 27 27 27 27 27 27 27 27 10 65 23 68 18 18 18 18 18 18 18 17 18 18 18 17 17 17 18 18 18 17 17 93 28 28 28 28 28 95 18 18 18 18 18 18 18 18 18 18 18 18 18 18 18 18 18 18 18 69 22 6 27 27 27 27 27 27 27 27 27 27 27 27 27 27 
27 27 27 27 27 27 27 27 27 27 27 27 27 27 27 27 27 27 27 27 27 27 27 27 27 27 27 27 27 27 27 27 27 27 5 23 68 18 18 18 18 18 18 17 17 17 18 18 18 18 17 18 90 18 18 18 18 28 76 77 28 28 95 18 18 90 18 18 18 18 18 18 18 18 18 18 18 18 18 18 18 18 18 18 24 64 9 27 27 27 27 27 27 27 27 27 27 27 27 27 
27 27 27 27 27 27 27 27 27 27 27 27 27 27 27 27 27 27 27 27 27 27 27 27 27 27 27 27 27 27 27 27 27 27 5 25 18 18 18 18 18 18 18 18 17 17 18 18 18 18 18 18 91 90 18 18 18 28 74 75 28 95 18 18 90 91 18 17 18 18 18 18 17 17 17 17 18 18 18 18 18 18 18 18 69 22 6 27 27 27 27 27 27 27 27 27 27 27 27 27 
27 27 27 27 27 27 27 27 27 27 27 27 27 27 27 27 27 27 27 27 27 27 27 27 27 27 27 27 27 27 27 27 10 8 65 25 18 18 18 18 18 18 18 18 18 18 18 18 18 18 18 18 18 91 90 18 18 94 28 28 95 18 17 90 91 18 18 17 17 18 18 18 17 18 18 18 57 56 58 17 17 17 18 18 18 24 6 27 27 27 27 27 27 27 27 27 27 27 27 27 
27 27 27 27 27 27 27 27 27 27 27 27 27 27 27 27 27 27 27 27 27 27 27 27 27 27 27 27 27 27 27 27 5 23 19 68 18 18 18 18 18 18 18 18 18 18 18 18 18 18 18 18 18 18 91 90 18 18 18 18 18 18 90 91 18 18 18 18 18 18 18 18 18 18 18 57 54 54 55 18 17 17 18 18 18 24 6 27 27 27 27 27 27 27 27 27 27 27 27 27 
27 27 27 27 27 27 27 27 27 27 27 27 27 27 27 27 27 27 27 27 27 27 27 27 27 27 27 27 27 27 27 27 5 25 18 18 18 18 18 18 18 18 18 18 18 18 18 18 18 18 18 18 18 18 18 91 18 32 18 18 18 18 91 18 18 18 18 18 18 31 18 18 18 18 57 54 59 54 55 18 18 18 18 18 18 24 6 27 27 27 27 27 27 27 27 27 27 27 27 27 
27 27 27 27 27 27 27 27 27 27 27 27 27 27 27 27 27 27 27 27 27 27 27 27 27 27 27 27 27 27 27 27 5 25 18 18 18 18 18 18 17 17 17 18 18 18 18 18 18 18 18 18 18 18 18 18 18 18 18 32 18 18 18 18 18 18 18 18 18 32 31 18 57 56 54 59 59 54 48 18 32 18 18 18 18 24 6 27 27 27 27 27 27 27 27 27 27 27 27 27 
27 27 27 27 27 27 27 27 27 27 27 27 27 27 27 27 27 27 27 27 27 27 27 27 27 27 27 27 27 27 10 8 65 25 18 18 18 18 18 18 18 18 17 17 17 17 17 17 17 17 18 18 18 18 18 17 18 18 18 18 18 18 18 18 18 18 17 17 18 32 32 31 47 46 54 54 54 55 18 32 31 18 18 18 71 20 6 27 27 27 27 27 27 27 27 27 27 27 27 27 
27 27 27 27 27 27 27 27 27 27 27 27 27 27 27 27 27 27 27 27 27 27 27 27 27 27 10 8 8 8 65 23 19 68 18 18 18 18 18 18 18 18 18 18 18 18 18 17 18 18 18 18 18 18 18 18 17 17 17 18 18 18 18 18 18 18 18 17 18 18 18 18 18 18 47 46 46 48 18 18 18 18 18 18 24 66 11 27 27 27 27 27 27 27 27 27 27 27 27 27 
27 27 27 27 27 27 27 27 27 27 27 27 27 27 27 27 27 27 27 27 27 27 27 10 8 8 65 23 19 19 19 68 18 18 18 18 18 18 18 17 18 18 18 18 18 18 31 17 31 31 31 31 18 18 18 18 18 18 17 17 18 18 17 18 17 18 17 18 17 17 18 18 18 18 18 18 18 18 18 17 18 18 18 18 24 6 27 27 27 27 27 27 27 27 27 27 27 27 27 27 
27 27 27 27 27 27 27 27 27 27 27 27 27 27 27 27 27 27 27 27 27 10 8 65 23 19 19 68 18 18 18 18 18 18 18 18 18 17 17 17 18 31 31 31 31 31 31 17 32 18 18 31 18 18 18 18 18 18 18 17 17 17 18 18 18 18 18 18 18 18 17 17 18 18 18 18 18 18 18 17 18 18 18 18 24 6 27 27 27 27 27 27 27 27 27 27 27 27 27 27 
27 27 27 27 27 27 27 27 27 27 27 27 27 27 27 27 27 27 27 27 27 5 23 19 68 18 18 18 18 18 18 18 18 18 18 17 17 18 18 18 18 31 18 18 32 32 32 17 17 18 31 32 32 18 18 18 18 18 18 18 18 18 18 18 18 18 18 18 18 18 18 18 18 18 18 18 18 18 18 18 18 18 18 18 24 6 27 27 27 27 27 27 27 27 27 27 27 27 27 27 
27 27 27 27 27 27 27 27 27 27 27 27 27 27 27 27 27 27 27 27 27 5 25 18 18 18 18 18 18 18 18 18 17 18 17 17 17 18 18 18 18 18 18 18 32 32 18 18 17 17 31 17 18 18 32 32 32 32 32 32 32 32 32 18 18 18 18 18 18 18 18 18 18 18 18 18 18 18 18 18 18 18 18 18 24 6 27 27 27 27 27 27 27 27 27 27 27 27 27 27 
27 27 27 27 27 27 27 27 27 27 27 27 27 27 27 27 27 27 10 8 8 65 25 18 18 18 18 18 18 18 17 17 17 17 17 17 18 18 18 18 18 18 18 18 17 17 18 18 18 17 17 17 31 31 18 31 31 31 31 18 18 18 32 32 32 18 18 18 18 18 18 18 18 18 18 18 18 18 18 18 18 18 18 18 24 64 9 27 27 27 27 27 27 27 27 27 27 27 27 27 
27 27 27 27 27 27 27 27 27 27 27 27 27 27 27 27 27 27 5 23 19 19 68 18 18 18 18 17 17 17 17 17 17 17 17 17 18 18 18 18 18 18 32 32 18 17 17 17 18 18 18 18 18 18 18 18 18 18 18 31 18 18 18 18 18 18 18 18 18 18 18 18 18 18 18 33 18 18 18 18 18 18 18 18 69 22 6 27 27 27 27 27 27 27 27 27 27 27 27 27 
27 27 27 27 27 27 27 27 27 27 27 27 27 27 27 27 27 27 5 25 18 18 18 18 18 18 18 18 18 17 17 17 17 18 18 18 18 18 18 18 32 18 18 17 17 18 17 17 17 17 32 32 32 32 18 18 32 18 18 18 18 18 18 18 18 18 18 18 17 18 18 18 18 18 18 33 33 33 18 18 18 18 18 18 18 24 6 27 27 27 27 27 27 27 27 27 27 27 27 27 
27 27 27 27 27 27 27 27 27 27 27 27 27 27 27 27 27 10 65 25 18 18 18 18 18 18 18 18 18 18 18 18 18 18 18 18 18 18 18 32 18 18 18 18 18 18 18 18 18 18 18 18 18 18 18 18 18 32 18 18 32 32 32 32 32 18 18 17 18 18 31 31 18 18 17 18 18 33 18 18 18 18 18 18 18 24 6 27 27 27 27 27 27 27 27 27 27 27 27 27 
27 27 27 27 27 27 27 27 27 27 27 27 27 27 27 27 10 65 23 68 18 18 18 18 18 18 18 18 18 18 18 18 18 18 18 18 32 32 18 18 18 18 17 18 18 18 18 32 32 18 18 18 18 18 18 32 32 18 32 32 32 18 18 18 18 18 18 17 31 31 31 18 18 18 17 18 18 33 18 18 18 18 18 18 18 24 64 9 27 27 27 27 27 27 27 27 27 27 27 27 
27 27 27 27 27 27 27 27 27 27 27 27 27 27 27 10 65 23 68 18 18 18 18 18 18 18 18 18 18 18 18 18 32 18 32 17 17 18 17 17 17 17 17 18 18 32 17 18 18 32 18 18 17 17 18 18 18 18 18 18 31 18 18 18 18 18 18 17 17 32 32 18 18 18 17 18 18 18 18 18 18 18 18 18 18 69 22 6 27 27 27 27 27 27 27 27 27 27 27 27 
27 27 27 27 27 27 27 27 27 27 27 27 27 27 10 65 23 68 18 18 18 18 18 18 18 18 18 18 32 32 32 18 18 33 33 18 18 18 18 18 31 32 18 32 18 32 17 18 18 32 18 18 18 17 18 18 18 18 31 17 17 17 18 18 18 18 18 18 17 17 17 17 17 17 17 18 18 18 18 18 18 18 18 18 18 18 24 64 9 27 27 27 27 27 27 27 27 27 27 27 
27 27 27 27 27 27 27 27 27 27 27 27 27 27 5 23 68 18 18 18 18 18 18 18 32 32 32 32 18 18 18 18 18 33 33 33 18 18 18 31 31 18 18 18 18 17 17 18 18 32 18 18 17 17 18 18 18 31 17 18 18 17 18 18 18 18 18 18 32 18 18 18 18 18 18 18 32 18 32 32 18 18 18 18 18 18 69 22 6 27 27 27 27 27 27 27 27 27 27 27 
27 27 27 27 27 27 27 27 27 27 27 27 10 4 65 25 18 18 18 18 18 18 32 32 32 18 18 32 32 32 18 33 33 18 33 18 18 18 18 31 32 32 18 18 18 17 18 18 18 17 17 17 17 18 18 18 31 17 18 18 18 17 17 18 18 18 32 18 18 18 18 18 18 32 32 18 18 18 18 18 32 32 18 18 18 18 18 24 64 9 27 27 27 27 27 27 27 27 27 27 
27 27 27 27 27 27 27 27 27 27 27 27 5 23 19 68 18 18 18 18 18 18 17 17 18 18 18 18 18 32 33 33 18 18 33 18 18 18 18 31 18 32 18 17 17 17 17 17 18 32 18 18 18 18 18 18 18 17 33 31 33 18 17 18 18 18 32 18 17 18 18 32 18 18 18 18 18 18 18 18 18 32 18 18 18 18 18 69 22 6 27 27 27 27 27 27 27 27 27 27 
27 27 27 27 27 27 27 27 27 27 27 10 65 25 18 18 18 18 18 18 18 18 17 17 17 17 18 18 18 18 32 18 18 18 18 33 18 17 17 31 18 31 31 31 31 18 18 18 32 18 18 18 18 33 33 18 18 33 18 18 18 17 17 18 31 18 18 17 17 18 32 32 32 31 31 18 18 18 18 18 18 32 18 18 18 18 18 18 24 6 27 27 27 27 27 27 27 27 27 27 
27 27 27 27 27 27 27 27 27 27 27 5 23 68 18 18 18 18 18 18 18 17 17 17 18 17 17 18 18 18 32 18 18 18 18 33 17 17 18 17 17 31 31 33 32 33 33 32 32 33 33 18 18 18 18 18 18 18 31 18 17 17 31 31 18 31 18 17 31 32 31 31 31 18 18 18 18 18 18 18 32 32 18 18 18 18 18 18 24 6 27 27 27 27 27 27 27 27 27 27 
27 27 27 27 27 27 27 27 27 27 27 5 25 18 18 18 18 18 18 18 18 17 18 17 17 18 17 18 18 18 32 18 32 32 18 18 17 18 31 31 17 17 31 33 33 18 18 18 31 18 18 18 18 18 18 18 18 31 17 17 17 32 18 31 17 17 17 18 18 32 18 18 18 18 18 18 18 18 18 32 32 18 18 18 18 18 18 18 24 64 9 27 27 27 27 27 27 27 27 27 
27 27 27 27 27 27 27 27 27 27 10 65 25 18 18 18 18 18 18 18 17 17 18 18 17 17 17 18 18 32 18 32 18 32 18 18 33 17 18 18 18 17 18 18 18 33 33 33 31 18 18 18 18 18 18 31 18 18 31 32 17 33 17 17 17 32 18 18 18 18 18 18 18 31 18 32 32 18 18 18 18 18 18 18 18 18 18 18 69 22 6 27 27 27 27 27 27 27 27 27 
27 27 27 27 27 27 27 27 27 10 65 23 68 18 18 18 18 18 18 18 17 17 18 17 17 17 17 18 18 32 18 32 18 32 18 18 33 17 17 17 18 18 17 18 18 18 18 31 33 33 18 18 18 31 17 17 18 17 17 31 33 18 31 31 32 32 32 33 32 33 32 18 33 33 18 18 33 18 18 18 18 18 18 18 18 18 18 18 18 24 64 9 27 27 27 27 27 27 27 27 
27 27 27 27 27 27 27 27 10 65 23 68 18 18 18 18 18 18 18 18 18 17 18 17 17 17 17 18 18 32 18 18 18 32 18 18 33 17 18 17 17 17 17 18 18 18 31 31 18 33 18 18 31 31 18 18 18 18 18 32 32 31 18 32 32 32 18 18 18 18 18 18 18 31 18 18 18 33 18 18 18 18 18 18 18 18 18 18 18 69 22 6 27 27 27 27 27 27 27 27 
27 27 27 27 27 27 27 10 65 23 68 18 18 18 18 18 18 18 18 18 18 17 17 17 17 17 17 18 18 32 32 18 18 18 18 18 33 33 17 18 18 18 17 17 31 31 31 18 18 33 32 32 31 18 18 18 18 18 18 33 32 32 32 32 33 32 18 18 18 18 18 18 18 31 31 18 18 18 33 33 18 18 18 18 18 18 18 18 18 18 24 6 27 27 27 27 27 27 27 27 
27 27 27 27 27 27 27 5 23 68 18 18 18 18 18 18 18 18 18 18 18 18 17 17 17 17 17 18 18 32 18 18 18 18 18 18 18 33 18 17 18 18 31 17 18 18 18 18 18 33 18 18 32 31 18 18 18 18 18 18 18 18 18 33 18 32 18 18 18 17 18 18 18 18 31 18 31 18 18 33 33 18 18 18 18 18 18 18 18 18 24 6 27 27 27 27 27 27 27 27 
27 27 27 27 27 27 27 5 25 18 18 18 18 18 18 18 18 18 18 18 18 18 18 17 17 17 17 18 32 32 18 18 18 18 18 18 18 33 33 17 18 31 31 31 17 31 18 33 18 18 18 18 18 18 32 18 31 32 18 18 33 18 18 18 32 32 18 17 17 17 18 18 18 18 31 31 31 18 18 18 33 18 18 18 18 18 18 18 18 18 24 6 27 27 27 27 27 27 27 27 
27 27 27 27 27 27 27 5 25 18 18 18 18 18 18 18 18 18 18 18 18 18 18 18 18 17 17 18 17 17 17 18 18 18 18 18 18 18 18 33 17 17 17 17 17 18 33 31 31 18 18 18 18 18 18 18 18 18 33 33 18 32 32 18 32 18 17 17 18 18 18 18 18 18 18 31 18 18 18 18 33 18 18 18 18 18 18 18 18 18 24 6 27 27 27 27 27 27 27 27 
27 27 27 27 27 27 27 5 25 18 18 18 18 18 18 18 18 18 18 18 18 18 18 18 18 18 18 18 32 18 17 17 17 17 18 17 17 17 18 18 18 33 18 33 33 31 31 31 31 18 18 18 18 18 18 18 18 18 33 18 18 18 18 31 18 17 18 18 18 31 18 31 31 31 31 18 18 18 18 18 18 18 18 18 18 18 18 18 18 18 24 6 27 27 27 27 27 27 27 27 
27 27 27 27 27 27 27 5 21 70 18 18 18 18 18 18 18 18 18 18 18 18 18 18 18 18 18 18 18 18 18 18 18 17 17 17 18 17 18 18 18 18 18 18 18 18 18 18 18 18 18 18 18 18 18 18 18 18 18 18 18 18 18 18 18 17 17 17 17 17 18 17 17 18 18 18 18 18 18 18 18 18 18 18 18 18 18 18 18 71 20 6 27 27 27 27 27 27 27 27 
27 27 27 27 27 27 27 12 67 21 70 18 18 18 18 18 18 18 18 18 18 18 18 18 18 18 18 18 18 18 18 18 18 18 18 18 18 17 17 17 17 17 17 17 17 17 17 17 17 17 17 17 17 17 17 17 17 17 17 17 17 17 17 17 17 17 18 18 18 18 18 18 17 18 18 18 18 18 18 18 18 18 18 18 18 18 18 18 71 20 66 11 27 27 27 27 27 27 27 27 
27 27 27 27 27 27 27 27 12 67 21 26 26 26 26 26 26 26 26 26 70 18 18 18 18 18 18 18 18 18 18 18 18 18 18 18 18 18 18 18 18 18 18 18 18 18 18 18 18 18 18 18 18 18 18 18 18 18 18 18 18 18 18 18 18 18 18 18 18 17 17 17 18 18 18 18 17 17 17 17 17 18 18 18 18 18 18 18 24 66 11 27 27 27 27 27 27 27 27 27 
27 27 27 27 27 27 27 27 27 12 0 0 0 0 0 0 0 0 0 67 21 26 26 26 26 26 26 26 26 26 26 26 26 26 26 26 26 26 26 26 26 26 26 26 26 26 26 26 26 26 26 26 26 26 26 26 26 26 26 26 26 26 26 26 26 26 26 26 26 26 26 26 26 26 26 26 26 26 26 26 26 26 26 26 26 26 26 26 20 6 27 27 27 27 27 27 27 27 27 27 
27 27 27 27 27 27 27 27 27 27 27 27 27 27 27 27 27 27 27 5 29 29 29 29 29 29 29 29 29 29 29 29 29 29 29 29 29 29 29 29 29 29 29 29 29 29 29 29 29 29 29 29 29 29 29 29 29 29 29 29 29 29 29 29 29 29 29 29 29 29 29 29 29 29 29 29 29 29 29 29 29 29 29 29 29 29 29 29 66 11 27 27 27 27 27 27 27 27 27 27 
27 27 27 27 27 27 27 27 27 27 27 27 27 27 27 27 27 27 27 12 7 7 7 7 7 7 7 7 7 7 7 7 7 7 7 7 7 7 7 7 7 7 7 7 7 7 7 7 7 7 7 7 7 7 7 7 7 7 7 7 7 7 7 7 7 7 7 7 7 7 7 7 7 7 7 7 7 7 7 7 7 7 7 7 7 7 7 7 11 27 27 27 27 27 27 27 27 27 27 27 
27 27 27 27 27 27 27 27 27 27 27 27 27 27 27 27 27 27 27 27 27 27 27 27 27 27 27 27 27 27 27 27 27 27 27 27 27 27 27 27 27 27 27 27 27 27 27 27 27 27 27 27 27 27 27 27 27 27 27 27 27 27 27 27 27 27 27 27 27 27 27 27 27 27 27 27 27 27 27 27 27 27 27 27 27 27 27 27 27 27 27 27 27 27 27 27 27 27 27 27 
27 27 27 27 27 27 27 27 27 27 27 27 27 27 27 27 27 27 27 27 27 27 27 27 27 27 27 27 27 27 27 27 27 27 27 27 27 27 27 27 27 27 27 27 27 27 27 27 27 27 27 27 27 27 27 27 27 27 27 27 27 27 27 27 27 27 27 27 27 27 27 27 27 27 27 27 27 27 27 27 27 27 27 27 27 27 27 27 27 27 27 27 27 27 27 27 27 27 27 27 
27 27 27 27 27 27 27 27 27 27 27 27 27 27 27 27 27 27 27 27 27 27 27 27 27 27 27 27 27 27 27 27 27 27 27 27 27 27 27 27 27 27 27 27 27 27 27 27 27 27 27 27 27 27 27 27 27 27 27 27 27 27 27 27 27 27 27 27 27 27 27 27 27 27 27 27 27 27 27 27 27 27 27 27 27 27 27 27 27 27 27 27 27 27 27 27 27 27 27 27 
27 27 27 27 27 27 27 27 27 27 27 27 27 27 27 27 27 27 27 27 27 27 27 27 27 27 27 27 27 27 27 27 27 27 27 27 27 27 27 27 27 27 27 27 27 27 27 27 27 27 27 27 27 27 27 27 27 27 27 27 27 27 27 27 27 27 27 27 27 27 27 27 27 27 27 27 27 27 27 27 27 27 27 27 27 27 27 27 27 27 27 27 27 27 27 27 27 27 27 27 
27 27 27 27 27 27 27 27 27 27 27 27 27 27 27 27 27 27 27 27 27 27 27 27 27 27 27 27 27 27 27 27 27 27 27 27 27 27 27 27 27 27 27 27 27 27 27 27 27 27 27 27 27 27 27 27 27 27 27 27 27 27 27 27 27 27 27 27 27 27 27 27 27 27 27 27 27 27 27 27 27 27 27 27 27 27 27 27 27 27 27 27 27 27 27 27 27 27 27 27 
27 27 27 27 27 27 27 27 27 27 27 27 27 27 27 27 27 27 27 27 27 27 27 27 27 27 27 27 27 27 27 27 27 27 27 27 27 27 27 27 27 27 27 27 27 27 27 27 27 27 27 27 27 27 27 27 27 27 27 27 27 27 27 27 27 27 27 27 27 27 27 27 27 27 27 27 27 27 27 27 27 27 27 27 27 27 27 27 27 27 27 27 27 27 27 27 27 27 27 27 
27 27 27 27 27 27 27 27 27 27 27 27 27 27 27 27 27 27 27 27 27 27 27 27 27 27 27 27 27 27 27 27 27 27 27 27 27 27 27 27 27 27 27 27 27 27 27 27 27 27 27 27 27 27 27 27 27 27 27 27 27 27 27 27 27 27 27 27 27 27 27 27 27 27 27 27 27 27 27 27 27 27 27 27 27 27 27 27 27 27 27 27 27 27 27 27 27 27 27 27 
27 27 27 27 27 27 27 27 27 27 27 27 27 27 27 27 27 27 27 27 27 27 27 27 27 27 27 27 27 27 27 27 27 27 27 27 27 27 27 27 27 27 27 27 27 27 27 27 27 27 27 27 27 27 27 27 27 27 27 27 27 27 27 27 27 27 27 27 27 27 27 27 27 27 27 27 27 27 27 27 27 27 27 27 27 27 27 27 27 27 27 27 27 27 27 27 27 27 27 27 
27 27 27 27 27 27 27 27 27 27 27 27 27 27 27 27 27 27 27 27 27 27 27 27 27 27 27 27 27 27 27 27 27 27 27 27 27 27 27 27 27 27 27 27 27 27 27 27 27 27 27 27 27 27 27 27 27 27 27 27 27 27 27 27 27 27 27 27 27 27 27 27 27 27 27 27 27 27 27 27 27 27 27 27 27 27 27 27 27 27 27 27 27 27 27 27 27 27 27 27 
27 27 27 27 27 27 27 27 27 27 27 27 27 27 27 27 27 27 27 27 27 27 27 27 27 27 27 27 27 27 27 27 27 27 27 27 27 27 27 27 27 27 27 27 27 27 27 27 27 27 27 27 27 27 27 27 27 27 27 27 27 27 27 27 27 27 27 27 27 27 27 27 27 27 27 27 27 27 27 27 27 27 27 27 27 27 27 27 27 27 27 27 27 27 27 27 27 27 27 27 
27 27 27 27 27 27 27 27 27 27 27 27 27 27 27 27 27 27 27 27 27 27 27 27 27 27 27 27 27 27 27 27 27 27 27 27 27 27 27 27 27 27 27 27 27 27 27 27 27 27 27 27 27 27 27 27 27 27 27 27 27 27 27 27 27 27 27 27 27 27 27 27 27 27 27 27 27 27 27 27 27 27 27 27 27 27 27 27 27 27 27 27 27 27 27 27 27 27 27 27 
27 27 27 27 27 27 27 27 27 27 27 27 27 27 27 27 27 27 27 27 27 27 27 27 27 27 27 27 27 27 27 27 27 27 27 27 27 27 27 27 27 27 27 27 27 27 27 27 27 27 27 27 27 27 27 27 27 27 27 27 27 27 27 27 27 27 27 27 27 27 27 27 27 27 27 27 27 27 27 27 27 27 27 27 27 27 27 27 27 27 27 27 27 27 27 27 27 27 27 27 
27 27 27 27 27 27 27 27 27 27 27 27 27 27 27 27 27 27 27 27 27 27 27 27 27 27 27 27 27 27 27 27 27 27 27 27 27 27 27 27 27 27 27 27 27 27 27 27 27 27 27 27 27 27 27 27 27 27 27 27 27 27 27 27 27 27 27 27 27 27 27 27 27 27 27 27 27 27 27 27 27 27 27 27 27 27 27 27 27 27 27 27 27 27 27 27 27 27 27 27 
27 27 27 27 27 27 27 27 27 27 27 27 27 27 27 27 27 27 27 27 27 27 27 27 27 27 27 27 27 27 27 27 27 27 27 27 27 27 27 27 27 27 27 27 27 27 27 27 27 27 27 27 27 27 27 27 27 27 27 27 27 27 27 27 27 27 27 27 27 27 27 27 27 27 27 27 27 27 27 27 27 27 27 27 27 27 27 27 27 27 27 27 27 27 27 27 27 27 27 27 
27 27 27 27 27 27 27 27 27 27 27 27 27 27 27 27 27 27 27 27 27 27 27 27 27 27 27 27 27 27 27 27 27 27 27 27 27 27 27 27 27 27 27 27 27 27 27 27 27 27 27 27 27 27 27 27 27 27 27 27 27 27 27 27 27 27 27 27 27 27 27 27 27 27 27 27 27 27 27 27 27 27 27 27 27 27 27 27 27 27 27 27 27 27 27 27 27 27 27 27 
